niang=釀嬢孃娘醸酿
lun=惀腀錀掄棆圇稐仑菕侖碖論崘崙踚抡溣耣伦沦蜦埨婨鯩淪輪倫磮轮陯芲囵纶綸论
luo=玀鸁渃蠃羅骆攊攎欏邏躒犖纙洛洜萝攞猡骡砢锣椤鮥箩皪攭倮咯漯瘰頱脶覶躶儸螺逻覼落騾笿蘿鵅剆峈囉捋硌鏍蓏蛒雒囖罗驘烙镙络臝摞珞跞饠絡腡硦荦曪籮啰捰磱駱癳裸泺詻濼鑼寽擽
nuan=暖煖煗湪餪奻渜
dei=得嘚
bai=挀贁唄摆猈庍柏絔呗敗稗擘韛拜拝竡栢败粨襬捭薭伯佰掰瓸擺粺白百
den=扥扽
ban=颁昄粄岅朌螌怑斑鈑斒頒办瘢钣肦辦舨褩阪搫搬般辬伴攽坂蝂姅絆闆柈版半绊拌癍跘秚鉡坢瓣瓪魬班扮扳湴鳻靽板
bao=薄包龅爆窇鴇怉袌鲍瀑鮑褒褓嚗宝堡堢笣儤报犦刨鸨蚫媬炮報抱宲骲犳暴趵枹忁闁駂襃葆铇鉋靌曓蕔齙寚保剝曝胞苞孢菢虣珤鑤剥緥裦佨饱髱煲賲寳藵鳵寶勹豹雹飹勽飽
zheng=脀丁征鬇争鴊抍徎箏眐怔憕掙猙錚媜撜崝掟炡崢挣綪爭踭鄭徰钲徴徵氶愸蒸証政幁揁睁证佂姃症聇證諍郑靕睜篜烝筝塣正诤埥峥癥鉦凧埩铮拯狰鏳整晸糽
lve=掠鋢稤略畧圙锊寽鋝
rang=穣壤瓤鬤让壌穰譲禳讓儴纕勷嚷攘蘘懹爙瀼獽躟
you=唀瀀有逌蜏輏优怞尢丣怣尤訧優鼬怮栯耰逰由甴猶輶猷攸游鄾鈾繇聈酉遊祐佑蕕牖牗浟楢卣蝣偤佦呦孧酭牰湵獶魷幼汼幽獿鱿麀貁憂梄禉鲉妋沋纋鮋梎侑羑冘嚘誘莜悠莠疣莤宥羪銪肬庮邮蚰亴蚴莸油犹斿铀駀揂苃又釉哊友櫌痏泑铕狖柚黝秞峟忧懮槱诱右峳郵迶姷滺櫾囿
ran=袡媣燃珃冄呥蒅髥蚦袇冉橪嘫姌繎熯髯肰苒染然蚺衻
fiao=覅
rao=桡隢娆嬈橈扰饒襓绕遶饶穘蕘荛擾繞
gang=罁摃戅犅戆掆戇冈堈槓岗崗疘碙刚剛扛肛杠鎠岡棡罡钢牨釭冮港綱纲焵缸焹犺筻矼鋼堽
ai=鎄薆唉嘊伌碍皑隑隘礙皚愛嬡馤焥璦暧皧堨挨欬娭霭溰銰爱鴱餲躷欸昹瞹砹蔼娾溾锿哀啀鑀埃靄叆靉硋嗌癌哎毐磑凒壒嫒懓曖懝絠嵦塧譪鱫濭矮噯諰捱敱嗳敳瑷藹賹譺僾艾
an=厂厈安按貋錌隌鞌鞍儑侒堓媕鶕暗谙洝誝鮟馣氨銨犴唵垵庵玵岸咹萻闇案桉葊荌鹌峖揞偣腤盦鵪盫蓭埯罯黯諳菴屵铵痷雸俺胺裺晻豻啽屽韽广
ao=袄嶅垇鼇璈爊梎眑岙澚蔜骜抝熝隞隩媪厫熬螯岰傲鰲澳嶴謷謸墺芺媼墽驁懊鏊鳌泑廒獒獓鷔鏕敖襖鏖拗擙磝慠奡奥奧遨郩柪軪摮嫯翱聱坳滶翶嗷扷嗸凹艹翺镺
cuan=竄汆巑欑鋑攒灒簒櫕攛窜篡攢躥爨殩镩穳熶鑹撺濽窽窾蹿
kua=晇楇誇跨侉垮挎胯姱絓咵趶恗夸銙骻舿
kui=傀溃瞆嬇鄈馈蒉謉暌頍亏憒夔隗馗骙悝喟戣簣騤窥愦愧殨躨犪膭匮尯頯匱刲嘳逵瞶蘷喹窺餽媿岿虁魁煃籄揆晆櫆磈藈巋饋奎楏楑篑盔巙闚顝蹞蕢聧虧鍨聩跬聭潰蝰聵葵鍷睽胿
ba=鈀鮁鲃皅鲅笆蚆茇覇把鮊鲌玐粑羓耙欛岜抜弝疤鼥炦吧妭芭犮伯钯颰朳丷爸霸垻夿跁魃峇仈胈跋捌叐扒拔詙坝菝豝灞魞釟罢壩八叭柭哱矲巴哵靶扷罷軷癹
hang=苀桁颃裄沆行絎頏笐迒妔筕绗邟蚢貥魧航吭杭夯垳巷斻忼
kuo=葀挄筈闊噋廓阔韕銛蛞鞟鬠拡頢铦扩霩括秮秳擴濶漷鞹髺銽萿
kun=堃悃涃阃昆稇貇騉褌醌崐崑猑綑堒錕稛焜锟鶤琨蜫閫梱鲲熴閸捆裈潉裍鹍菎睏晜髠髡坤鯤髨裩婫困硱祵壸瑻壼鵾
bi=币萆朇弊愊鼊蜌愎鰏笓笔贔匕紕嬖鄙堛娝萞吡崥鄨縪鄪稫怭舭贲紴鐴夶嬶怶弻鼻弼朼逼蔽畀畁彃屄楅襅筆饆驆佊豍鉍煏畐赑坒魓祕蹕佖詖鵖獘獙啚筚佛聛陛荜敝襞婢湢畢幣襣幤睤睥偪奰繴潷腷荸彼罼避皀斃粃躃躄箅鮅禆箆咇庇閇閈閉粊榌貏梐袐疕皕螕沘芘熚薜馝鶝鎞鞞辟閟妣璧碧疪纰貱邲肶鞸妼綼鲾柀髀壁賁拂臂必旇胇铋泌珌翍鏎诐哔比毕秕毖蓖滗秘毙駜鷝毞濞韠廦篦裨鷩闬滭闭觱柲髲篳毴狴嗶飶跸痹痺蓽俾苾
bo=欂謈搏餑蔔脖蘗簙帛礡萡踣渤挬伯礴紴砵舶簸鈸餺猼愽缽簿鹁噃镈艊驋鱍襏鉑譒鵓牔博佛穛卜剝浡鉢剥葧襮鑮桲蹳驳彴啵癶癷孹饽煿薄碆溊膊鮊鲌馎榑肑嶓箔殕誖嚗檗檘鎛馛馞撥皪播袯袰亳趵钵袹钹玻侼蚾駁铂勃壆髆胉髉泊盋鋍柏擗擘狛跛瓝瓟僠菠秡仢波郣拨苩懪糪柭駮僰哱磻淿
cen=埁岑参笒參叄涔叅汵穇篸嵾
hou=齁逅糇鄇郈喉洉瘊後篌后鲎葔垕銗鲘候厚鮜豞鱟堠矦茩翭鍭侯餱呴猴翵鯸睺骺吼犼吽帿
duan=塅煅毈褍缎媏耑瑖簖躖鍛緞籪碫剬断短葮端偳椴鍴段腶斷锻
xing=侀省騂謃鈃興型骍鮏洐刑醒銒莕倖钘娙星邢性皨猩涬餳箵垶嬹悻篂瑆荇緈郉陉煋狌行滎硎杏铏曐姓葕臖哘陘婞鋞巠形擤腥荥饧觪睲觲兴蛵鉶幸鯹惺
bu=蔀箁布踄鈈逋不悑餔鸔怖咘钚堡餢吥誧抪醭庯钸錻鈽簿婄鯆佈廍勏鵏轐埔捕埗捗卜補卟埠晡步补柨歨部歩鳪峬捬篰郶荹哺瓿
huang=熀鐄皇鰉謊爌隍谎媓肓朚璜騜皝喤鎤榥簧徨縨皩趪堭餭愰崲怳墴宺锽炾熿癀篁衁曂塃晃黃晄黄鳇滉幌慌煌恍櫎艎遑鱑荒穔蝗揘獚奛瑝偟巟湟葟鍠潢兤詤蟥鷬凰惶韹磺楻汻諻
sen=襂森椮槮
ca=嚓囃攃礤拆擦礸遪
a=錒嗄呵锕吖啊腌阿
b=倂标怉堋逋瀌倍砏怑瀑頒瀕怖耙堛栟堡堢栢栤逩逬怭砭報怲倴砵怶頻逼偋遍聛偝塝灞硥补表偪灬桮顮桲桳塴偹避颁墂炃梆碆邉邊袌傍梐袐悑碑肑频悖梖備碚炞邠傡碥炦肦邦傧碧颩被邫炮颮袯袰颰悲邲炳邴肶邶颷梹袹壁僃僄棅磅壆飆胇飇胈飈胉飊背棑飑棒棓飙飚補胞僠郣郥磦裦裨部壩惫僰裱郶飶飹磻惼飽鄁愂餅备変愊褊愎儐椑餑褒褓餔椕脖焙褙鄙餠礡餢儤儦鄨褩鄪夯夲礴夶餺愽褾夿脿襃楅襅饆祊楍煏襏襒奔祕奙襞奟襣八襬襮奰饱煲兵腷煸饼饽煿禀膀禆覇憊膊憋榌覍馎榑膑膔膘禙熚熛馛榜馝馞妣冫妭醭冰覵妼駁臂駂姅釆秉臏秕臕秘秚駜槟釟秡懪駮臱觱鈀爂爆鈈鈑稖稗標娝稟別刨稨舨别稫般舭鈵舶爸鈸鈽扁婄驆版婊艊鉋驋鉍牑艑鉑扒牓牔艕詖詙穛剝鉡婢鉢剥驫牬扮穮扳鉳驳扷鉼誁抃窆犇窇窉骉把犕誖檗檘芘抜办骠报抦檦犦誧抪媬芭犮抱骲檳犳骳諀髀拂勃苄髆鋇狈髈髉拌髌鋍勏嫑拔髕諘諚狛拜拝竝苝苞髟竡拨苩髩苪苯髱鋲髲狴勹勽狽苾挀欂鬂包笆茇猈謈猋笓鬓笔匕嬖北謗欛錛鬢笣謤笨挬猵嬶錶挷錻猼匾笾魃筆半捌卑譒魓捕捗獘獙博筚孛卜荜卞魞卟捠孢步歨歩捬魬捭獱荸孹捹荹鍽箁鮁莂箄箅鮅箆變鎊鮊玐鮑箔殕鎛宝鎞殡玢玣掤玤鮩殯箯掰宲玻宾鯆珌寎鏎叐诐比毕毖变揙毙寚菝毞菠菢鏢珤篦叭班篰鏰寳篳毴寶菶揹篻揼珼鯾鯿萆搏鰏搒琕簙萞吡萡琣谤吥吧搫琫搬琲鐴氷簸萹鐾簿汃屄摆葆摈鱉鑌豍鱍屏摒籓呗屛豝鑣鑤葧籩豩鑮汳豳汴瑸豹摽粃鲃粄岅鲅咇粊鲌鲍貏粑咘沘钚岜貝蒡钡钣撥璧粨撪播钯貱钵貶璸钸钹粺鲾賁铂糄峅峇铇泊鳊铋泌泍糒蓓賓哔賔鳔蓖鳖擗擘瓝瓟波瓣瓪糪鳪峬擯哱賲哵泵鳵瓸哺擺鳻蓽瓿蔀贁甂唄贆鴇蔈甏蔔贔紕鴘锛贝崥败崩贬甭甮贲紴攽蔽畀畁絆镈鵏畐赑镑鵓絔蕔镔镖鵖敗啚畚镚浜敝浡畢絣嵭鵯镳啵綁斃薄閇閈閉斌閍斑斒嶓疕薜鶝閞閟鶣疤疪薭喯綳趵疺綼旁跁闁病闆旇藊跋跘嗙跛鷝藣緥編藨鷩闬痭闭跰淲巴藵嗶緶跸痹痺淿渀币昁布昄踄不縍鸔蘗丙帛昞瘢嘣踣渤並鸨昪瘪縪阪瘭帮丷昺鹁陂噃繃陃幇虌癍鹎蹕幖幚陛癟晡湢幣虣幤蹦虨蹩幫蹳湴繴并癶幷癷癹白繽百皀躃麃蚄躄皅蚆庇溊蚌庍皕嚗皪蚫庯庰纰亳庳暴蚾蛂盃蛃仈绊盋仌廍绑仒曓蛖滗曝仢廦滨滭滮軰绷軷雹份蛽弁朇鼈弊鼊朌蜌缏编弝缤鼥霦輩眪本伯蜯漰朳伴霸伻弻鼻弼朼缽坂蝂彃彆佈佊坋坌靌轐靐坒杓佖蝙齙佛坝坢罢睤睥佨彪彬彭杮杯佰彴併靶潷罷彼罼靽板鞁龅鞆辈枋螌羓螕鞕鞛鞞龞辟辡鞤辦徧辧辨辩垪辫辬鞭辮辯鞴徶鞸垹枹边辺垻侼便柀忁埄柄必柈翉翍柏濒埔埗韛保濞蟞埠韠蟦柨忭柭濱埲柲矲俵濵柸迸俻俾
ce=廁栅敇冊测册簎厕策萗蓛荝筞畟厠憡箣粣侧笧夨測側筴萴拺恻惻
c=蠀萃倅栅簇倉吋簎簒搓琗萗怚栨逪琮怱萴蠶倸蠺层汆灇顇灒聡顣層聦摧偨聪遪屮呰聰衰葱偲呲摲瑲瑳遳側汵鑶鑹恻摻瑽灿籿璀璁碂粋肏岑墔傖粗撡財粢粣悤沧璨邨傪蒫催傮撮悰粲悴傶粹撺蒼磁裁棇磋棌蓌操糍糙泚蓛賜飡擦惨賨賩磪惭蓯賶瓷蓸飺惻壿攃脃甆脆餈锉椊夎儏餐崒攒崔蔖错攛鴜脞蔟焠礠愡蔡攢财紣礤蔥焧夨脨鄵礸愺脺褿酂慅敇酇慈襊啋测啐赐慒慘絘啙慙襙慚啛慛嵟畟祠腠嵢楤镩嵯楱嵳兹嵾趀憁嶆冊薋趋醋册嶒薒涔趗熜醝憡趡熣趣膥趨疩膬鶬憯喰憱榱疵綵膵熶綷鶿鷀藂懆采臎藏跐凑巑凔觕凗淙痤燦臧淬差槯跴槽瘁瘄樅嘇嘈刌縒縗爘騘丛爜瘥踧鸧爨縩踩樬測縬瘯舱騲樷刺刾踿驂婃驄婇穇噈剉蹉湊噌湌才扐剒驓虘艙蹙艚鹚詞橧蹭繱穳蹴蹵艸鹺橻鹾蹿麁麄麆皉誎嚓纔蚕骖庛窜皠骢麤躥媨暰庴皴誴骴隹皻銼窽窾廁竁苁囃滄竄拆髊囋雌苍从諎鋑仓蛓櫕囪黪囱竲黲竴拵曹仺拺曺曽曾鼀朁匆欉欌漎茐欑笒漕漗伜猜鼜猝錝缞嬠次謥茦伧笧匨嬨茨挫錯謲輳伺漼朿潀蝅潈睉草獊佌材村卒策存荝筞此潨彩睬孮鍯孱筴齹佽徂殂螆鮆鎈澊残辏垐従徔厕徖殘瞛厝莝辝從枞辞侟厠採莡箣辤螥侧殩措螬辭澯玱掺玼莿寀埁珁参促參叄叅翆柌蟌词鏒鏓忖鏙菜毝翠篡叢濢鏦濨忩鏪矬篬埰忰毳篵寸濸篸濽
d=砀頂砃堆瀆逇耊栋耋耑倒递瀓逓頓頔堕頕逗砘怛堞怟怠怢瀢堤砥蠧頧瀩逮倲堵耵耷蠹逹瀻怼耼耽逿遁顁聃塅遆恎硐偒道達桗偙灙顚顛聜衜遞衟塠聢档恫灯遯遰偳恴衴顶聸硾顿墆碇碉墊梊袋傎墑梑肑碓邓炖碘肚袛炟碟碠颠傣墥墩颩墪梪墫碫墬碭墮碮墯墱碲悳袳墶碷邸点悼梼僀壂胅胆裆惇壋働棏磓壔惔烔郖僜棟棣飣僤惦胨惪惮裯惰裰磴胴惵磸郸磹裻都磾飿儅礅椆儋褋焍褍礑愓愖餖椗焘多夛褝椟椡褡椣餤大鄧椯脰鄲椴夺褺奃煅腅兊酊祋兌奌襌饏兑腖酖酘党腚兜奝兠奠襠腣饤奪楪楯奲饳楴奵祶腶襶祷典慸饾禂醈妉醏妒憕禘憚憜憝憞覩禫冬妬馰禱馱妲覴憺冻膻膽馾覿燀懂駄槇燈燉凋觌凍燑釖釘駘凙槙姛懛觛槝觝凟懟槢釣姤駧秪釱凳駳燵臷秺凼燾刀樀刁刂訂鈄訋鈍刐訑戙戜刟鈟舠娣戥鈬到稲騳刴戴舵爹娻稻鈿剁扂橂牃詄詆牍驐牒詒打艓橔艔驔牘扚詚艜婝橝剟艠艡剢扥鉪剫剬婰剳牴橷婸艼扽媂誂媅犊抌窎媏芏檔誕抖銚犜窞媠犢檤窦动銩読檮銱窴抵窵骶調鋀狄担竇櫈諌鋌苐髑動苖狚諜櫝拞諟嫡髢諦髧竨狪独勭勯端竳苳狵苵竺鋽嬁笃挅挆鬌挏匒欓挕錖笗笚笛嬞錠挡鬥鬦笪鬪第鬬錭鬭匰匵嬻鍀獃荅譈等鍍答单単荙鍛魛筜荡譡魡捣獤獨捯荰荳鍴譵歹荻讀掂殆掇掉箉鎉鮉掋箌厎玎玓宕鮗鮘定殚殜讜鎝掟讟订厧箪殫殬玬殰玳段玷掸箽厾殿菂菄叇毈诋提鏑毒诒鯛诞鯟叠篤揥菧叨菪毭叮揰珰揲毲鯳篴珶对读叼导篼対菿调鰈吊吋對谍導氎萏氐簓鐓琔簖搗氘鐙谛簜鐜簞簟谠氡萣簤鐤簦吨搭氭尮氮琱鐸氹簹吺鐺琽鐽鑃豄呆豆瑇汈豋屌汏呔摕瑖鑟董呧籪葮籴豴鱽呾蒂貂咄撉钉沊沌咑璒沓钓璗撘咚岛钝撢撣貣咥蒧璫钭沰岱沲撴鲷貸岻岽鲽钿瓄哆泆哋擋峌铎哒峒擔瓙哚铛瓞蓞铞擣铤铥鳥蓧賧铫瓭賭鳭糴島泹瓽贉甋蔋唌鴏蔐甔蔕贕唗唙甙崜锝唞洞紞崠鴠攧攩鴩崬锭鴭崵电贷甸蔸町锻崼甼紿镀敁啇蕇敌赌啍啑敓畓赕啖啗畗敚镝敟浟敠浢嵣畣敦镦絧絩蕩敪蕫镫嵮絰鵰啲畳敵啶當镻嵽鵽啿嵿斁疂趃趆鶇疉疊喋嶋嶌疍疐綐趓疔斗閗薘涜嶝綞薡斣涤趤喥鶫断單薱嶳斷涷疸趸嶹淀痁淂巅藋跌闍嗒巓巔跕痘闘緞締淡藡跢闣痥跥旦跮嗲旳痶跶跺痽緿嘀丁嘄帄瘅阇帎渎鸐帒嘚东帝丟嘟队渡丢带渧阧瘨瘩鸫踮帯蘯帱踱踲昳帶踶昸丹瘹阺阽嘾蹀蹈噉幉癉陊蹎陏噔癚蹛癜噠陡蹢陦乧繨湩癫幬蹬虭陮虰癲蹲噵晵繵噸噹登蹾嚁的隄嚉庉躉隊隋暏隓底躖店溚纛隝亣隥度嚪蚪躭蚮隯躱嚲躲隳亶亸嚸皽皾蛁仃曃軃盄滇軇蛋滌绐軑雕黕绖廗盗軚仛黛盜點曡代囤軧黨軩黩盪黮盯黱滴黵黷廸盹電軼雼仾盾雿伄伅眈缍缎鼎蜑鼑伔弔眔缔蜔鼕霘弟眣弤鼦蜨霮地眰眱蜳弴霴圵朵朶朷弹弾蝀佃蝃但靆睇彈坉蝊低潒当佔坔杕坘佚轛靛杜杝潡督轪靪坫彫蝭靮靯東蝳蝶杸睹坻齻靼彽澄待垈瞊垌羍枑鞑枓垖龖侗得瞗龘螙徚垛垜羝侢澢鞢垤枤螩瞪垫螮鞮垯垱澱螲徳德侸澹辺达柁柂韃埅韇忉埊忊柋濎迏迖迚埞翟柢翢柣韣俤韥柦濧迨迪埬埭短迭柮忳石矴埵迵蟷濻蟽追翿
ch=倀怅怆蠆怊瀍瀓倕栕耖砗倘堘頙耛耝怞逞倡耡蠢栦頳場逴怵瀺耻堾础顀偁遄聅遅偆塍偖塖桘遚偛灛恜衝硟遟偢恥硨硩衩遫顫衬桭塲遲塵硶灻硾偿墀碀袃炊墋梌邌炒肔傖傗悜碜肜肞肠梣颤储炪肫袲傳袳梴碴悵傸傺梼炽惆棎裎郕棖僘惙磛僜僝惝僢烢磢磣胣壥棦裧惩磭裭飭裮裯棰烲裳郴胵惷棽烾愁儃处椆褈椉儊椎焎礎鄐儔儕愖椘椙褚鄛償餟焣脣夦褫儭脭椯焯儲儳愴餷焻椽鄽椿煁酁楂腄充慉兏奓饓慗煘楚襜饞腟祡酧酫酬饬楮襯奲酲慸腸奼煼冁憃禅憆榇禇醇馇榋馋憏膓醔憕醕膗覘妛醜膞醦憧禪膪冲馳憷醻熾净燀秅臅槆觇凈槌种重槎懘觘臣懤秤処触釧臭称臰槱懲懴釵觸姹出懺燽臿騁舂鈂樄刅樆程刍娍訍成樔鈔娕娖樗创舛初爞稠爡舡訦舩刬訬騬爯刱稱戳訵刹船娼牀橁牊剎牎剏鉏鉓橕牕橖艖剗剙橙牚艟扠扡婤婥橦詧穪詫艬扯牰驰扱橱創婵剶詶剷鉹橻婼剿承穿誃銃抄芆檉犉劋媋骋銐犓窓劖窗誗檙檚窚芚銟誠抢骣犨助檫犫檮誯媰犲窲抶媸誺抻窻芻窼抽竀苂諂諃櫄勅拆櫉狋鋋竌苌竐勑鋓諔櫖鋜鋤櫥勦嫦櫬鋮苴勶諶拸鋹拺竾持欃嬋茌謓猖謘錘匙茝笞茞錞嬦欩錩欪茬猭鬯挰茶猹茺欻欼挿謿歂筂譂捇捈荈鍉孎荎獑魑单鍖魗歜歠鍤筬歭歯孱捵卶捶筹荿莀掁厂讇箈鎈箎讎莐讐讒玔讖莗鎗鮘玚鎚宠殠箠掣殦厨掫宬厰宸箹掺箺莼鏃篅菆叉揊鯎插菖菗篘菙鯙毚诚察鏟揣诧鯧揨篨篪诪珫菭揰叱寵珵揷珹叺珿鏿搀吃谄氅簅萅鰆萇搊搋谌搐谗尘氚琛吜尝鐣琤搥琩吵搶氶萶谶吷吹尺鐺搽瑃呈豉汊摌汌籌呎摏瑏摐瑒鑔摖豖摚摛池豠鑡摢鱨呫屮摰鑱摲摴摷瑺豺摻岀粆蒇沈沉钏撐撑蒓岔沖钗貙粚撜钞蒢撤撦蒭鲳璴沶貾鲿擉泏铖賗铛賝泟哧賰铲铳蓴峸瓺瓻哾紁贂锄洆唇崇崈唓純攙甞鴟锠攡產産锤紬崭蔯唱锸絀鵄畅蕆敊敐浐絒敕嵖啜畜敞畤赤浧赪赬浱镲啴畴镵敶長镸浺絺啻畻嵼畼浾絾赿长疀趁趂嶃嶄超疇鶉涌喍趎鶒鶗喘鶙綝鶞喠趠疢綢斥閦鶨趩喫單疮涰喳閳薵鶵斶閶斺趻薼綽緂跈巉痋淌嗏巐淐鷐嗔淖闖鷘巛闛川緟闡巢跢巣嗤淨差闯淳痴旵痸藸緽旾緾跾踀嘃瘈阊昌踌瘎阐丑丒踔嘗瘛丞踟瘡春瘥瘨帱鸱串嘲丳瘳踳昶阷常踸踹嘼嘽晁湁噄蹅噇陈鹑處蹖乗乘陙繛幝晟繟癡幢除幨晨虫幬噭幮蹰陲陳繵湹湻晿虿隀蚇躇床躊嚋亍麎纏嚐纒嚓躔躕溗皗暙暢产麨蚩嚫纯庱蚳嚵麶暷嚽滀滁囅囆仇車绌蛏雏黐雔軙廚仛廛盛雛黜曟廠雠滣仦雦仧仩盩仯绰雴绸滻蛼鼂霃漅圌鼌蜍朐漘眙鼚弛朝輟传缠伡朣伥漦伧眧弨伬輲漴輴眵场朾佁杈睈轈罉蝉齒齓齔靗杘齝齣车彨蝩齪靫齭潮彲彳杵杶睶潹潺罺坻彻杻坼齼杽蝽罿齿龀垂澂澄瞅侈澈龊瞋辍徎垑侘侙徜瞝垞瞠龡枨侪螭瞮辰侱徲螴辵澶辶徸徹螹羼辿埀翀矁韂矃翄柅翅濋城忏蟐韔埕矗迟迠忡迡柢翤俥查俦迧翨埩埫蟬埱忱蟲柴蟵俶蟶査柽蟾俿
e=騀鄂锇砈堊鈋頋匎阏砐鰐餓谔愕搕礘訛洝頞頟搤娥琧堨砨阨餩吪鈪鰪堮锷阸戹搹萼娾娿崿阿婀噁蝁湂呃齃鹅硆鵈敋睋譌遌額顎遏偔鍔鹗屙蕚呝鵝歞鵞豟魤噩鑩腭轭恶齶鱷歺遻扼卾饿厄蚅岋讍涐誐皒枙颚鶚额咢覨垩悪莪妸咹讹閼妿磀俄鳄廅峉苊迗軛擜惡諤哦峨鋨峩僫囮櫮珴姶軶痷痾蛾
f=封尃砆鐇琈萉堏砏琒鰒氛砜蠜砝氟吠簠逢鐢倣怤否鐨吩砩瀪怫頫蠭萯栰瀵堸琺堼鐼氾栿瀿灃呋灋葍汎豐偑葑呒摓籓鱕屝鱝豧偩衭豮衯桳桴籵豶汸桻偾汾鲂炃傅咈粉鲋岎咐炐钒袚袝邞傠璠負邡墢沣梤肤炥肥墦沨風販岪粪肪撫钫颫炰粰颰悱袱鲱墳梵蒶沷璷沸碸肺梻費鲼颿鳆胇峊飌风胏棐糐胐法胕郙泛郛飛峜飜飝糞飞棥烦賦鳧僨瓬鳬泭峯飯鳯峰烰飰蓲鳳棴賵裶哹鳺棻賻鳻僼棼烽鴀夆複锋鴋鴌复洑紑褔鴔焚紛鄜负紡愤焤餥椨焨紨贩唪夫甫礬脯椱紱餴崶甶鄷费紼放蕃镄襆酆煈畈奉畉祊奋赋浌襎畐腐腑楓祓腓祔畗赗赙饙酚奜蕜酜蕟啡蕡絥襥蕧畨煩鵩番饭奮浮浲赴敷腹奿覂妃覄覅覆妇妋綍福斐榑綒醗綘妚膚馚鶝薠馡妢熢憣禣憤閥馥妦斧榧冨妨馩涪鶭馮冯疯膰醱冹方膹疺趺趽疿姂藅姇旉旊緋燌秎緐淓燓燔跗旙駙旛釜淝凡釡凢凣凤凨藩釩凫凬鷭凮緮懯痱巿秿阀鈁稃訃渄分帆鈇帉昉訉樊瘋不娐昐騑鈖帗昘縛騛刜訜阜阝渢舤舧蘩稪訪縫舫丰昲防蘴父嘸踾房乀艀癁繁艂詂噃橃附幅癈扉橎乏婏婓婔剕払湗鉘繙虙鉜幞幡牥婦橨幩陫副蹯艴乶扶驸発發纀暃溄蚄媍犎檒抙芙抚府废蚠蚡芣蚥蚨麩隫芬麬躮犯麱芳纷麷麸蚹誹纺犻芾犿拂绂黂廃拊曊绋竎仏滏狒鋒軓盕竕蛗付盙拚櫠廢髣諨髪勫軬雬仮髮绯雰髴諷仸仹黺苻黻滼黼份盽仿茀蜂范弅蜅朆猆眆蜉朌服嬎伏嬏朏霏伐匐嬔輔伕鼖弗匚缚蜚缝鼢弣鼣匥猦符漨笩匪眪茯笰蜰笲鬴笵缶茷缹輹錺缻輻霻輽彂荂鍅靅坆坊捊靊坋杋筏鍑轒轓獖罘孚罚佛蝜非坟筟靟蝠鍢罦捬杮蝮罰佱坲荴魴孵魵彷罸坺坿彿箁瞂鮄辅枋枌枎辐莑羒鮒宓澓瞓殕垘箙厞玞垡玢讣復莩枫鮲羳羵玸枹垺讽鎽访翂埄範埅濆翇篈柉俌富反韍柎珐发菔返俘篚俛忛鏠翡鯡蟦韨柫柭俯菲俷寷濷俸柹翻诽矾忿
ci=蠀趀甆螆鮆餈皉薋垐縒庛鴜辝辞礠次粢辤茦嬨栨茨辭骴疵伺刺玼刾朿莿鶿鷀珁磁慈髊佌柌雌糍词赐跐蛓絘啙泚鹚賜詞祠此偨濨差呰呲瓷兹齹飺佽
ming=眀蓂嫇名鄍明慏瞑凕茗銘朙暝溟螟榠鸣冥酩覭铭佲姳眳鳴掵洺詺命猽
g=耇堈耈耉個倌堌瀔耕怘逛倝堝栝逧堩怪栱蠱根格堽耿桂桄硄硅硊灌硌硍過恑聒遘聝恠塥衦遦桧顧塨灨恭灮衮桰顾桿傀炅颈傋颌墎梏肐梗炗碙炚炛肛肝袞股傦袧颪肱颳悹悺袼碽邽袿郂惃磆惈郌棍胍裓僙磙郜棝郠棡烡郭惯僱胱胳裷裹棺胿椁褁褂夃愅餜椝够感夠褠椢館愩椩夬夰愲焵脵礶餶夹焹餻夾焿腂楇光慐酐慖腘襘慣酤祪公祮祰共煱关祴煹饹祻祼概馃馆冈膈馉覌冎膏規冓熕膕榖馘禞冠榦妫禬冮覯観榾槀觀槁观规凅槅秆臈構臌凎觏姑槓釓槔懖觚姟觡槣姤觤觥臦槨槩臩槪釭姯臯凲臵觵槶槹槻槼姽稁戅戆戇戈稈樌鈎稒戓騔舘刚鈛爟鈣戤騧戨騩刮刯鈲鈷舸樻刽訽稾刿稿穀詁橄詌剐剛扛扢鉤牨牫詬橭詭剮艮牯橰割該鉻牿詿劀犅抇芉劊檊劌窐銛檜功窤芥誥銧骨骭媯犵芶犷檺犺骼銽媾銾骾勂櫃櫊櫎拐狗拘高髙櫜苟嫢諣括鋯櫰拱拲嫴櫷苷髸鋼苽諽勾竿嬀挂匃匄挄匌挌謌匑猓匔茖茛欟笟猤茥匦錧茪匭挭匮錮匱笱猲鬲笴謴鬶錷鬹鬼筀魀歄荄獋鍋歌魐卝孤卦獦筦筶獷歸筸筻宄莄掆箇箉鮌玍箍鎑玕鮕官鎘掛箛莞鎠管鮥宫厬鎬鮭宮鮯掴玵鎶厷掼玽鯀鯁毂诂鏆菇毌叏篐菒菓珖诖珙篙篝鯝诟寡诡篢古句该叧珪菮揯菰诰鐀搁簂各搄搆合簋尕尜搞吤鰥尬琯尲尳簳尴尶尷谷鐹簼吿搿氿摃呄告鑎摑鱖呙葛摜汞鱞摡葢鱤豥鱥汩摫瑰呱呴汵鑵鱹豿撀咁蒄鲄钆撌鲑粓咕咖岗撗钙璝沟鲠岡貢钢咣岣鲧钩貫璭咯貴钴鲴咼沽粿擀瓂賅蓇賈蓋瓌賌哏鳏峐泒糓泔糕蓕瓘蓘瓜鳜賡鳡鳤哥铦铬擱鳱泴峺鳺峼糼購哽哿糿唂唃紅锅锆紇蔉贑崓崗甘鴚贛唝崞贡锢鴣购崮蔮贯攰鴰攱贵洸改紺攻攼贾鴿啂故赅镉畊敋镐啒絓赓絙絚絠畡敢赣給啩浭啯絯赶綆鶊趏喐趕疘疙閞嶡斡涡関薣閣閤閨涫綱嶲疳綶綸趹鶻痀藁巂緄淈淉嗊鷎嗗闗關嗝跟工淦巩緪跪巬巭旮痯嗰旰緱鷱藳緷緺闺痼阁嘅縆昋嘎縎嘏丐瘑嘓鸛瘝縞嘠渦丨个鸪蘬港帰丱鸹踻帼鸽湀幊癏晐癐陒鹒陔乖幗鹘乢虢干鹳噶晷癸幹虼乾广亀躀広亇皈溉庋皋溎皐隑隔亘亙庚溝红蚣纥庪躬皯纲躳纶皷皼蚼绀蛄廆滆黆雇蛊雊軋軌滒蛒軓盖囗给滚雚雟仠绠仡廣蛤盥蛫盬囯盰軱绲軲更囶固囻国廾滾圀輁輄國漍漑缑朒弓鼓鼔鼛缟輠輥漧輨圪圭眭估輵缸朹伽蜾彀彁罁轂佄潅杆罆蝈彉彍罐归睔轕杚杛罛佝罟杠罡潢罣轨坩革睪佫罫坬佮轱杲坸佹睾构侅瞆鞈澉侊辊鞏龏澒垓羔龔羖垙羙龚供果辜龜垝螝龟瞡垢羮鞲枴瞶鞷枸澸羹鞼瞽羾迀埂濄俇过蟈忋矌韐柑忓矔埚韚柜矜矝韝韟蟡柧濲矸柺矼
h=怀頀逅頇瀈砉頏蠔堕瀖蠖耗怘候怙堚瀚蠚頜堠耠瀤逥瀫堭逭頮耯倱耲怳頶頷核耾桁衁塃顄恆行恍恏灏遑恒桓硔聕恗恚衚恛灝偟硡衡恢顥桦桧恨顪火灬塰灰灳灴硴恵顸颃還袆碋颌悍悎傐梒肒颒肓悔袔颔邗悙梙邟颢患肣邩墮邯墴傼炾烀郂郃裄烆磆郇郈烉壊棍壑惑惒棔壕烘惚惛郝壞惠烠僡胡烣烩胲壶惶壷烸壺磺胻焀餀椃焃焄餄鄇礉焊礊愌礐褐焓焕鄗褘椛餛焝脝鄠焢褢夥愩儫餬餭夯餯愰褱餱椲儶椷夻慁楁奂煂酄煇慌煌楎奐慐饚奛楛楜祜酣兤奤煥慧兯奯煳煷祸饸楻酼好熀馄妅熆熇禈覈禍妎醐憓妔馠醢榥憨熩熯馯冱膴憾禾熿姀懁秏懐槐臛釛觟姡槥觨釪釫槬燬釬駭姮秮凰姱槲懳秳觳槴燴秴駴槵懷觷燺駻函懽秽凾爀娂訇爌訌戏划或舙鈜騜騞娢鈥横航戯戱戲爳戶訶户戸訸樺戽扈驊鉌婎艎穔婚扞橞婟穢詤詥艧剨驩詪婫橫穫詯話婲婳鉷詼鉿劃檅骅抇骇媈銊劐芐媓檓芔銗檜窢护誨媩誮花抲芲銲檴犴芴骸骺犼劾銾犿苀櫎鋎狐鋐竑竓諕櫘鋘諙苛狟狠鋡狢諢諣竤嫨拫嫭嫮櫰苰諱拸苸拻諻嫿猂嬅謊謋鬍笏笐嬒笒化嬛謞鬟茠匢欢猢挥鬨茩匫匯欱猲猴茴錵謼猾錿譀荁譁獂魂鍃獆捇孈卉孉獋捍华歑荒歓譓獔筕鍙獚歛荟魟鍠歡换荤鍧魧筨孩獩荭譭鍭譮鍰魱獲荷護鍸譹魺魽獾譿厂厈掍宏玒宖殙讙厚玜鮜掝莟鎤宦讧殨鎬环鮰害讳箶厷获许宺毀毁篁诃毇鯇揈寉篊篌寏菏寒篕揘诙換毜话菡寣篧诨珩毫寭揮華寰鯱珲篲诲鏵鯶号鏸鯸毼叿琀萀鰀萂簄鐄合萈鰉后谎萑吓鰗吙鰝尡琥氦簧吪含鐬吭吰搰搳鰴鐶谹吼谼吽谽谾琿豁豃鑅汇籇汉鑉鑊呍瑍鱑葒葓葔汗豗呙呚瑚瑝豞葟鱟摢豢摦豪葫汯鱯豰豲呴呵汵屶屷葷屸呺籺汻呼屽鲄沆貆貈貉咊蒊和咍沍沎鲎粐撔撖撗沗鲘貛璜撝蒝咟粠璤貥蒦貨鲩沪钬粭璯環咳河咴岵咶撶咼撼蒿糀賀哄賄峆糇鳇哈糊泋蓋哏擐泓哕哗峘泘瓛哠瓠鳠瓡铧瓨铪糫哬擭鳱瓳鳸哻哼洃洄唅紅鴅紇攉洉蔊崋攌蔒紘蔛唝甝崡唤紦蔧货洪锪唬紭蔰崲鴴洹贺活画鴻攼锽锾唿贿嵅敆鵆啈嵈浍鵍絎蕐镐浑浒絗絙蕙浛啝鵠浣浤浩浫畫赫镬镮絯浲畵絵海蕻薃綄閄薅涆薈閈喉薉喊綋閎趏喐綔喖鶘喙喚喛斛喝閡鶡涣喤閤涥鶦薧閧薨趪鶮鶴涵涸斻鶻涽閽鶾嗀闀闂嗃藃巆嗊淏嗐痐闔痕闞巟闠旤闤嗥藧嗨鷨緩痪嗬闬鷬淮旰旱藱淲闳淴巷混藿阂蘅丆昈昊瘊鸌帍阍縎昏嘑嘒昒瘓阓阖鸖渙阛嘝踝縠瘣蘤昦縨嘩昬渮渱蘳嘷渹蘹鸻渾蘾嘿帿鸿癀晃晄鹄噅噈癋幌虍乎晎虎湏噑幑乕噕鹕晖湖虖鹖晗晘乚虝湟號幠繢湣繣鹤噦晦晧癨繪鹮乯繯湱鹱噷湷虷虹虺幻虾溃嚄溄嚆嚇皇暉皋隍嚎互皓隓皔嚖蚘嚛皜嚝皝蚝皞暠嚡皡红蚢暤亥皥纥麧亨皩皬暭纮嚯暳隳暵蚶溷隺嚾麾嚿曂黃黄廆盇滈雈滉盉黉黊黌曍盍雐滑黑盒黒蛔蛕盖绗雗囘绘雘滙雚仜滜回仠軣曤蛤軤囫囬滬曶曷滸滹廻廽雽蛿圂會眃圅朅缋霍霐眓缓弖蜖弘伙会圚朚輚圜輝霟漢弧蜬蜭鼲缳漶漷輷鼾齁潂靃佄睅睆彋轋靍靎坏靏潓何罕齕彗蝗轘彙彚彟轟彠潢睢蝦睧靧佪杭睯潰轰睳睴蝴潶佷轷佸杹睺垀龁鞃澅很辉徊後垎鞎澏瞏枑澒螒澔垕澕螖螛螜螝枠龢澣羦徨鞨垬澮侯垳侴澴垸瞺徻徽垾羾翃韄矆柇濊矐俒迒忓韓埖还翙翚翝濠蟥矦濩韩蟪翬翭翮翯俰翰迴翵忶韹忼忽翽俿
j=倃怇逈怐瀐倔逕怚倞瀞耞借耟倢耤急倦倨耩耭瀱進瀳倶瀸倹瀽灂假偈灍恔聙灚聚恝健聥偮灸聻偼遽悁炅悈傋肌悎傑傔傕傢肩炬邭炯悸傹肼烄僅郆惊郊惍惎郏僒惓胛僟郟郡僣惤僥烥僦惧僪胫僬烬僭烱僵胶僸價郹儁鄄儆焆儉脊儌焌焏焗儘脚脛焣脥焦脧愱愳焳脻腃腈煍煎腒酒煚煛煡兢慦慬煯腱酱腳腵酵其具慻兼兾冀冂冋膌憍冏膙军熞憠膠憢醤熦憬醬醮憰熲膲决醵熸憼冿憿净釂臄懅燇臇凈燋减懏金釒凚燛燞几懠凥釥臦臩臫臮釰臶臸击懻懼燼臼釼釿戄舅刉舉舊戋鈌刏舏爑戒刔戔戛爝戞鈞戟戢刦刧戩截戬刭舰爴爵刼鉀剂扃剄扄鉅牋艍剑剞牞扢剣鉣剤艥艦剧剪鉫牮艰剱艱扴鉴鉸剹艽剿技銁劂节犄銄抅劇銈抉劋犋犌劍犍劎劑犑劒劔犗銞犟加銡劤芥芨劫芰犱劲劵芵抸劼勁拁鋄狊勌鋏鋑拒鋗拘狙苙鋞拠狡勣拣苣狤勥勦鋦勬勮拮苴狷鋸鋻勼猄錈匊挍茍茎猏匓挗挙匛匞挟匠挢挤茤錤錦茧茭茮猰猳茳匶挶匷挸挾捁捃捄荆荊獍獎捐荐鍓捔荕鍕獗卙荚荠捡獥獧卩荩卪据捲即鍳鍵卷捷卺鍻卽玃鎅掎玑莒玖莖掘莙玠莢厥接玦玨厩厪玪鎫掬莭掲鎵掶鎸玾揀菁揂揃菅珇珈及菊菌珏珒珓珔叕叚叝揟鏡揤菤句菨鏩揪叫揫菫揭菳揵鏶珺菺叽搅吉鐍琎鐎鐖鐗琚君搛萛鐝搢吤鐧搩鐫鐱吷琻鐻琾呁葁鑇瑊呌葌摎瑎葏瑐鑑鑒摖鑙呟瑨摪葪鑬葭鑯葰鑳瑴摷摾瑾咀钁撃璄撅钅蒋咎璚钜撟璟蒟撠璡璣璥撧钧蒩璬咭璶撹蒹蒺撽璾钾撿擊擏擑擖铗據哜蓟擠擧擮铰擳蓳蓵擶瓹蓻哿蔇攈唊锏锔攕攟蔣锦唧蔨锩攪蔪唫攫键锯攲甲唶蕀蕉界镌畍敎啑救蕑镓畕教镜蕝畟镢敧蕨敫敬畯蕳畸啹镹畺蕺镼敽啾敿畿疅疆喈薊疌斍薑閒間疖斚疚斝喞斠斤疥疦薦喬閰斺薺喼疽疾痂闂藆痉藉旌旍痎藎旔嗘痙嗟藠旡既旣旧间痵嘂嘄阄昅嘉蘎蘏嘐蘔瘕瘚昛蘜瘠嘦蘮嘰阱阶蘻虀虃癄际晈晉噊晋噍降陖噘晙癠虠虡噤癤癪噭虮景噱陱虳晶皀皆嚌嚍皍皎階蚐暕蚗際暞皦蚧暨暩皭隮皲蚷皸皹暻嚼隽曁雃集雋雎囏监曒曔囝雞蛟盡監蛣囧雧蛱蛶蛺朁霁圈圏蜐眗朘蜛朞期蜠霵眷机朻霽圾圿均睊蝍睑坓靓蝔坕坖靖坙静坚靚睛靜睠杢杦睫靬坰杰靳睷螀极鞂枃枅瞉鞊垍螏鞙鞠枧鞫鞬瞯鞯架螶枷瞷枸螹瞼瞿螿鞿韀韁埆埈埉韉埍矍埐埛柜矜蟜矝矞矡蟣埧蟨柩矩蟩矫柬蟭韭韮矯韲矶基蟼埾柾砄堅堇砎堑蠒蠘頚砛蠞砠校頡堦栫頬頰堲蠲頵頸堺堻蠽堿桀塂塈顈塉桊桔桕街顜桝桨桱衱桷硷衸桾衿袀境碅袈颈颉碊颊梋颎墐袓梘梜梞碣袦梮碱颶梷袷袸墹袺墼检壃壆壉裌裐裓飓壗棘裚棞飢裥棬飬磯磵飷磼裾礀礁餃椄夅礆椇椈餋礍椐椒礓餕礛検餞椦褧褯餰椵椷礷夹夾椾襀奆奇襇襉饉襋奍楐饑奖楖楗襟饥奨楫奬楬祭饯祲極楶楷襷奸她奺襺饺妀禁馂榉覉覊見妌妎榎覐馑妓妗榗榘覚妜禝覠榢馢榤禨覬覲覵覸馸覺见駃槉觉駉觊駏姐觐角駒秔觔駕姖觖觙槚槛姜姞姢姣槣解姦姧觧駫姬秬觭觮积姰槳駶秸觼槿駿訆娇計稉訐樔稘記樛娟訣稩樫樭稭稴娵稵稷稼稽詃穄婅穊積詎橏婕驕穖婘橘婙穚驚婛橛婜橜機驥婧穧驧婮詰穱橶究橸驹婽穽驾橿骄檋誋窌媎骏檕窖媘窘檝檞檟誡檢骥誩媫窭誱骱誳檵窶檻嫁嫅櫅諅嫉髉諊諓諔竞竟竣嫤櫤竧竫諫櫭竭競櫸竸竻髻櫼笄欅笅謇笈鬋嬌欍鬏嬐笒嬓笕講嬧謭欮鬮謯笳謹笺謽鬾孂筊筋譎歏譏孑譑孒孓筓魕譛魝筠魢季譤筥譥魥警筧魪歫歼譼譾简讂鮆鮈宊箋殌箐宑殑鮔箕箘鮚殛箟计殣讥讦殧鮫殭箭记殱殲讲讵家鮶箿節诀寂寄毄寋毑寖诘鯚寠毠鯦鯨毩诫寯篯毱毽鯽将將簊簎鰎谏尐氒鰔尖鰜簡簥谨谫就谲簴鰶鰹谻尽氿鰿局鱀鱂居屆豇籈届籍鱎屐籛豜江汣豣汥屦豦屨屩屫汫汬豭鱭汮屰汲決鱾粇岊岌貑鲒粔岕貗鲚鲛貜岠鲣岨鲪鲫岬沮粳粷鲸精泂泃泇賈鳉糋賋賎賐鳒糘鳜糡峤賤泦峧糨鳩賫泬賮鳮泲賷糺峻系鳽泾糾紀洁鴂鴃洊崌洎贐鴐紒洚級崛紟鴡紤津紧崨崫洯洰贱鴶贾鵁浃浄浅絅嵆浆赆嵇浇鵊鵋経赍济結嵑鵑鵔浕絕鵕鵘鵙浚鵛絜絞嵥給絭絳赳鵳嵴鵴絶浸絸嵹浹絹浻赽鶁趄鶄涇趉鶋趌鶏涓經嶕綗継鶛趜趝趞嶠嶡綡鶡嶣嶥涧綨鶪趭嶯嶰嶱嶲趹涺鶺嶻趼鶼巀淁緁巂淃鷄巈跈緊跏鷑跔淗緘跙緝距巠跡鷢跤鷦巨淨巪鷮己跲鷲践巹巻跻跼跽巾踁鸄済縉踋丌渐踐縑踑且踕踖踘減踞渠鸠鸡帣丩丮丯港縳帴帺踺丼踽举績乁鹃久乆蹇繋幏蹐湒湔湕繘幜九湝繝蹟鹡乣鹣湨乩鹪乫湫繫蹫鹫乬湬繭繮幯繳幵蹶鹶蹷鹸鹻繼鹼幾麂亅溅躆麇麉躋溍庎麏纐麔井麕麖麚亟纠麠交躤级躩纪京亰庴躸躹亼亽廄仅黅今車介軍廏经仐廐滐廑结滘给绛绝绞绢继绩廭滰件价建輂漃較缄弆漈缉伋漌伎伒漖缙弜伡弡缣弪弮輯缰鼰鼱弳鼳缴弶強漸强伽弿漿彅轇彊齌轎齎彏齏彐潐彑齑潔潗轚罝轞齟罥车齨佳佶彶佼罽齽轿羁羂澃较龃径澆羇羈澋徍徑辑澗徛龜侟龟徣龣徤侥徦侭羯侰侷徺徼澽激忂濅濈俊忌近俓进濜翞濟忣俥迥忦翦迦濬俭俱迳俴迹濺迼
k=堀堁堃考尅簆砊砍頍怐堒搕栞砢頢簣倥鐦頦琨堪氪萪吭尯頯栲逵尻砿萿葀硁硄籄框顆恇鱇豈衉塊桍硍衎塏恐顑恗偘鑛硜顝硞鱠豤聧鑧聩恪聭硱恳摳呵聵葵恺瑻硻摼硿傀岂悃粇貇墈悈蒈蒉炌肎颏鲓咔袔炕咖颗鲙悝邝邟梡岢炣墤碦钪咯璯肯蒯梱岲鲲咳袴咵钶貺肻邼颽墾悾岿郀況惂裃磆峇磈裈裉裍哐胐郐铐擓磕烗哙壙糠铠磡烤裤铦糩胩裩铪哭胯壳擴棵壸壼胿铿崁褃焅崆儈鄈礊椌褌脍锎崐崑愒夔愘洘愙礚焜锞锟儣愦礦愧洭蔲褲锴贶鄶愷攷夸鄺蔻夼餽愾嵁敂啃煃楇克絋饋嵌浍奎楏嵑楑奒絓絖嵙楛絝鵟蕢敤嵦慨嵪祵慷楷酷嵻鵼鵾喀涃馈開醌閌綑憒妔薖馗醘冚閜喟鶤冦薧閫膭嶱涳熴疴况趶趷閸喹榼喾膾駃懇鷇藈闊巋跍嗑科闓臗巙秙緙闚槛巜旝闞釦跨懬跬懭秮凯凱姱秳凵闶凷旷槺痾闿丂阃嘅昆渇稇騉刊爌騍娔瘔阔樖阚稛稞戡戣騤鈧阬丱刲刳嘳鈳渴蘷刻昿舿剀牁虁穅晆晇剋噋鹍艐扛晜扝蹞扣虧扩婫穬牱鉱噲鉲剴空扻牼剾鉿抂溃誆誇纊窋暌亏犐誑犒骒库抗隗溘誙銙骙窛銛暟窟抠窠亢芤劥窥躨纩犪庫銬課嚳蚵銵劶康骷犺窺劻檻躻骻窼窽銽窾媿躿勀髁狂狅櫆勊髋黋勓廓盔绔軖髖勘竘苛鋛髛狜嫝蛞曠軠髠拡髡廤囥廥苦軦髨括軭狯困滱拷竷髺軻开錁缂會挄輆嬇伉謉看眍挎朏圐猑錓錕眖眗会匟鬠匡輡圦匩霩蜫鬫欬匮漮欯匱挳欳欵眶漷圹錹匼款欿歀捁歁魁彄捆鍇坈筈潉蝌坎睏筐坑孔块轗筘佝卝鍞靠卡坤佧鍨獪潰蝰轲坷筷鍷筺睽龂侃瞆龈侉瞉瞌鎎龕瞘鞚龛箜鞟客垦控鎧殨侩羫鮬垮澮掯枯垰瞰莰垲鮳瞶殸鞹殻宼殼宽揁珂揆寇俈迋矌鯌菎篑诓韕翗鏗矙寛揢珢口鯤叩揩埪快寬濭鏮可柯埳诳濶忹矻忼矼忾课矿
zhei=这
l=老瀂耂倆〇倈瀏耒瀘怜瀝倞耢耣連逦瀧耧瀨逨倫瀬耬倮瀮耮逯倰瀲瀶逻瀾恅灅灆聆聊恋聋灓联灕聗遛灠恡灡灤聨聫聮聯遱遴灵偻遼聾傈炉悋肋邋邌邏邐炓悝悡悢悧炩傫悷邻炼惀僂烂僆僇烈郎惏郒僗郘烙僚郞郦胧胪烮僯郲烺焒脔儖焛鄝脟儠儡儢愣儮鄰儱脶儷脷儸脸鄻脼儽腀酃慄酈煉腊腡兩慩酪六煭慮兰酹慺憀醁膂醂膋憐膐熑膔熘熝膟熡膢憥憦膦冧醨醪膫憭熮醴醶冷冽醽臁臈凉臉凌里懍燎量燐釐懒凓懔釕燗臘臚凛凜臝臠釠臡懢燣燤臨燫燯懰懶燷戀爁爄爈爉爎爏爐爒刕爖列刘爛刢爤爦爧利鈩戮舮舲鈴舻戾艃剅剆艆剌扐剓扚艛鉝牞牢艣艪艫良剹剺艻犁犂劆銇劉銐犖劙力犛銠抡犡劣犣劦芦銮励芲劳労劽鋁鋃勆苈拉勎拎狑勒苓苙鋝勞勠拢鋢拦狫鋫鋰勴勵鋶狸狼錀猁錂錄錅猍猎茏錑挒挔挘茘挛猟猡茢錬匲録匳錴錸鍄鍊捋荔荖卛捛獜捞獠卢卤獦荦捩捰荲卵獵獹玀掄莅历率玈厉莉鎌玏鎏掕厘鎘掚掠厤鎦莨厯鎯厱莱厲玲莲掳莶厸厽鏀菈鏈菉珋鏍鏐珑叓叕珕菕鏕珞菞鏤另揦揧鏧鏫珯菱鏴叻菻鏻揽搂鐂琅理琉萊琌琍吏琏鐐鐒吕搚琜吝萝鐪琭搮鐮萰琳鐳落呂摎葎瑓呖鑗鑘摙摝摞鑞摟瑠鑢呤鑥鑨鑪瑬鑭瑮瑯鑸葻鑼鑾撂璃钄撈璉蒌钌璐蒗璘咙璙蒚撛蒞璢蒥咧撩咯璷撸璼咾擂瓃铃擄瓅蓅瓈蓈瓎瓏蓏瓐瓑铑瓓蓝铝蓠哢蓢蓤擥瓥哩蓮哰哴瓴哷擸铹擼蓼铼擽蓾链攂蔂锂蔆攊甊锊攋蔍锍唎攎攏甐锒攔攞蔞唠唡攣锣唥攦甪攬攭唳蔹蔺唻蔾镂畄啉镉蕌镏蕗留镙敛镠啢镣略镥啦畧镧镭啰镰畱镴蕶啷敹镽畾蕾疁斂斄疄喇薍斏薐斓斕薕疗料閝薟疠喨疬閬閭喱斴閵喽斿旅旈闌藍旒藔藘藜藞藟嗠痢痨旯藰痳藶嗹藺藾闾蘆阆瘌嘍阑瘘蘝嘞蘞阞蘢瘣昤瘤蘦蘫蘭嘮瘰蘱蘲嘹瘺蘺瘻昽蘽阾蘿療虂癃癅癆虆陆陇虊陋虏虑噒癗癘癛噜虜癝癞癧癩陯癳癴癵陵陸晽晾嚂隆皊嚕暕嚟嚠隣嚦暦嚧嚨皪隴隶隷暸蚸隸嚹暽囄曆囇囉蛉蛎囒蛒雒囖蛚盝曞盠蛠雡曢離曥盧曨曪曫盭蛯雳囵零雷囹圇蜊霊蜋朎朖霖朗霗圙霛圝霝圞蜡朤霤圥朥蜦朧蜧眬露霳朸蜽靁靂靇靈蝋靋李睐靓坔睖睙坜杝睝睞来睩蝲坴蝷蝼坽螂垃垄垅垆螊垏垒林瞜鞡枥枦瞭螰瞵螺螻鞻柂柃柆蟉韊矋埌蟍矑埒埓矓蟟蟧埨柳韷蟸栁栃蠃砅蠇栊蠊栌堎栎栏栗領栛頛堜蠝蠟蠡砢蠣蠦蠪頪蠫砬蠬砱頱栳砳栵砺砻頼栾砾塁顂塄硉硌衑硓塛桞類顟硠硦硫塯塱顱顲硵塶塷桹桺塿梁碄颅领梇袊碌碐碖墚梠颣梨颲梸梾梿飀棂磂裂飂棃飅棆壈飉磊壏磏裏磖裗飗壘棙壚壟磟壠磠裡壢裢壣裣磥壨裬磮棱磱裲棶磷裸磿椂椋夌礌餎褛椤礧礨礪礫礰礱礲褳褴褵褸礼餾奁楋襕楝襝楞饠祣襤奩襰奱祱襱襴饹楼楽襽祾祿榄禄榈馏榔覝覧禮禲榴覶禷离覼覽馿姈览槏駖秝槞駠秢槤姥駱姴駵駺觻樂稂樃娄騄樆稆娈騋娌樏樐稐樑稑樓娕樚樛稜稤騮娳稴騼娽騾婁詅婈詈橉橊穋驎橑驑驘穞婡驡驢婨婪驪穭橮婯橯穲驴橹詻檁窂誄骆骊窌誏檑骝媡骡檩檪檶窷媹誺窿竂髅竉立髎嫏髏櫐櫑諒櫓櫔櫖論髗嫘櫚竛竜髝櫟嫠櫣櫨嫪櫪竰櫳櫴櫺竻嫽嫾鬁欄鬎欏欐鬑欒欖欗欙嬚欚鬛欞笠謢鬣謧笭謰謱鬲欴鬸嬼笼嬾笿孁孄魉孋譋孌魎孏筙歛筣筤孪魯魲歴孷歷孿魿箂讄讈殓箓讕箖鮤鮥箩殮鮱论箻鯉鯏篓诔毟寠鯠篢寥篥鯥鯩鯪鯬篭寮篮篱鯻寽氀谅氇鰊氌簍簏簕簝尞鰡尥尦尨簩簬氯谰鰱鰳簵簶氻簾籁豂籃豅豊鱗籙屚籚籟籠屡屢籢籣履鱧籨鱩屪籬籮鱱鱲鱳屴屸鱸鱺类鲁鲈貍粒貗岚粝鲡鲢鲤沥岦沦粦粩岭粮鲮粱沴粴沵粶岺粼賂賃峈峍糎泐鳓賚峛鳞泠峢鳢峦糧鳨泪峲糲賴泷糷泸泺賿崀崂崃崊洌崍鴒鴗崘崙崚贚洛洜洡累紷鴷鴼流赁嵂赂鵅赉鵉浏嵐浖赖嵝絡鵣鵦嵧浨浪絫浬浰鵱赲浶鵹嵺絽嶁鶆嶐趔涖嶗嶙涙嶚嶛涝綝涞涟綟綠趢綸綹鶹嶺涼綾巁巃巄鷅緉跉淋緑巒淕淚鷚鷜跞巤淥淩淪路鷯練淶鷺鸁渃踉渌鸓鸕鸗帘踚踛踜鸝鸞両两鸬縭鸰縲临縷縺丽鸾繂鹂湅繆乐蹓繗蹗蹘繚鹠蹥鹨鹩鹭湰乱幱鹵鹷湸蹸蹽乿繿鹿亂溂亃纅了溇纇纍麍躏庐躐麐纑躒溓麓麗躘纙躙纚溜纜麜纝躝纞麟麢溣溧躪亮庲麳躴纶躶亷躼軁仂軂练廇廉廊黎仑廔廖廘络滝令滤滥滦黧軨廩廪廫绫廬廲滷黸绺绿弄輅缆漉漊漋輌漏漓缕輘輛缡漣漤伦缧缪輪輬缭漯伶鼺漻轆潋罍罏轑彔轔录罗潞轠齡轢齢轣轤轥潦佬轮罱轳罶罹轹彾潾羀辂龄羅來辆澇羉例律辌龍羐澑龒侓龓徕侖龗辘龙羚辚澛澜澟徠辢侣辣澧澪澰侶羷羸辽徿濂忇翋俍翎翏俐濑濓俚忚连迣俩俪俫濫翴翷濼濾迾濿
m=码栂耄砇怋瀎蠎們蠓蠛砞蠠堥砪瀰耱堳蠻怽衇恈衊塓灖桙顢遤硥偭灭硭顭塺塻恾墁邁袂梅碈邈傌炑墓悗邙颟袤梦墨袮悯悶袹碼僈棉烕惛胟磨売僶惽壾郿脄脈脉愍鄍愐脒焖愗夘儚椚鄚礞夢脢夣礣鄤鄮礳鄳鄸祃饃饅免慏慔襔慕祕酕楘楙祙饛慜腜煝饝慢祢楣煤酩慲楳酶腼冃冇妈馍冐熐冒覒馒榓覓覔冕覕冖禖妙醚覛膜冞榠冡禡冥冪榪憫馬覭禰熳妹冺妺醾醿凂姄釄觅姆懋姏秏懑槑秒凕燘秘懜燜懞懡駡懣秣姥凩釯懱臱姳懵駹槾戂爅娏娒樒樠刡模樢爢娨娩鈱戼驀婂橅穆穈艋牑艒橗鉚牟牡牤牦牧鉧艨扪鉬马牳詸詺牻鉾骂媄銆芇芈媌媒芒媔劘犘銘媚犛劢媢銤檬劰檰骳檷犸抹劺媺抺芼媽抿櫁鋂勄嫇拇狇勉櫋髍勐勔櫗竗苗嫚苜募苠狢髦鋩嫫勱嫲髳狵嫹苺嫼笀謀茂茅茆茉錉嬍謎謐猕鬕茗鬗鬘猛笢嬤謨錨謩猫茫謬錳挴嬵嬷笷猸茻猽笽鬽謾獁魅鍆孊獌獏魔卖孖孟魩捪鍪捫荬孭卯鍲獴魹獼歾歿宀殁鎂玅鎇莈宓莓莔厖殙玛玟玧玫莫莬莯掵厶鎷厸鮸掹宻莽莾篃密珉鏋鏌母鯍毎篎描每寐毛菛鏝寞毣毪鯭毷珻菻篾吀氁吂氂氋谋萌名民氓吗琘簚尛谜琝谟簢鰢搣谧尨谩谬鰵萺鰻瑁瑂葂汅瑉汒鑖屘葞呡呣汨摩瑪摱米鱴摵汶摸摹命葿貃貈貉璊貊貌粎沐沒貓沔钔沕貘蒙没咩咪沫沬沵岷買钼蒾貿峁蓂糆铆泌铓峔瓕泖鳗鳘峚糜擝哞擟糢賣哤蓦蓩铭泯賯鳴擵哶糸蔄甍崏蔑蔓鴓鴖攗锚唛蔝攠洣蔤锰蔴贸洺鴾甿镁畂敃嵄敄蕄镅畆镆絈敉嵋嵍敏畒蕒絔镘浝畝畞畮敯絻浼镾門閁閅薎鶓閔喕斖鶜鶥閩喵薶綿旀旄跊藌鷌緍嗎藐痗緜痝緡緢藦淧门緬痲緲痳闵鷶闷旻痻嗼旼淼闽渂万踇蘉鸍明踎丏鸏渑蘑帓嘛嘜帞鸣嘧昧昩嘪蘪蘰渳昴渵縵縸渺縻渼瘼蘼帽嘿幂湄繆么湈虋鹋陌幎湎湏幔幕幙鹛乜湣幦癦幪幭乮买鹲虻満蚂皃庅纆亇麊暋麋皌嚒暓溕庙麛嚜暝蚞溟嚤溤麥麦亩暪麪麫庬暮暯嚰麰麵亹麺麻麼麽躾庿皿麿滅蛑蛖默黙曚軞廟盟满黣蛨仫们目蛮雮仯盲盳黴滵绵雺曼黽黾滿盿眀霂眄缅鼆眇缈眉霉眊鼏缗朙朚眛眜蜜漞漠眠霡蜢霢弥霥朦缦木缪末漫弭漭眯眳朷眸圽眽霾眿霿靀睂佅坆彌睌蝐蝒杗罞蝞罠靡面杣潣靣蝥睦靦杧杩杪睰蝱佲罵坶睸靺瞀羃瞄枆瞇枈垊羋侎美瞐瞑瞒侔鞔瞙羙枚瞞螞螟澠瞢螨鞪澫瞴澷枺徾蟆矇蟇矈迈矊蟊埋蟎韎矏某矒蟒濔蟔柕矕濗忙濛矛忞忟迷濹
bing=禀誁倂餅鞆窉枋琕丙昞鞞栟稟餠傡掤栤並抦鮩垪眪冫冰庰怲檳炳邴鈵氷鞸梹昺蛃陃柄棅病秉偋仌寎屏靐仒摒屛竝槟絣苪鋲併兵并幷鉼饼
n=鐃堄逆栍耎耏簐耐搑怒怓堖氖萘搙氝氞鐞蠥搦耨怩倪砮蠰搱萳吶倷搻尼氼瀼逽怾倿尿恁聂衂摄衄硇鑈籋聍摎聏鑏呐屔遖瑙桛硛桡呢灢聣恧摨屰摰衲硳顳呶聶鑷硸籹聹聻恼汼豽籾貀钀炄袅鲇傉貎沑撓钕粘蒘碙撚咛梛颞钠那悥袦您傩悩肭钮碯袲蒳袳撵鲵鲶碾擃惄峊裊铌郍糑胒哖惗铙哛哝泞泥糥鳥瓧瓩哪烪擬胬糯擰瓰峱惱瓱糱瓲郳糵瓼能棿儂甅攆脌納紐脑夒餒脓儗锘儜唜攝儞夞愞唟蔦褦椧餪蔫褭攮脮甯脲脳愵男唸儺儾焾腇鵇奈腉镊镍镎浓煖煗畘兙兛襛敜兝兞饟楠兡饢兣腦內赧襨腩啮嵲女奴煵奶兺奻腻浽蕽酿馁喃内涅涊喏榐疑榒疒疓馕閙农馜妞疟妠嶩膩嶭妮禯醲妳涳薴喸醸憹膿薿釀秅痆槈秊巎旎闏臑闑駑巕旕淖秜跜凝懝臡釢淣秥懦嗧懧姩嗫臬觬淰嗱臲燶槷釹闹巼秾戁踂帇縇鈉鸋縌帑鈕蘖踗娘踙娚娜渜娞鸟樢訥瘧稬鈮昵渿乃蹃虄橈詉艌蹍虐癑蹑穒婗噛牛乜牜橠穠橣穤乥噥婥陧蹨婩乪湪扭乲晲湳年繷乸婻湼驽艿嚀檂媆隉躎抐麑溓暔暖嚙抝躡嚢抩努隬蚭暱抳纳檷檸銸溺檽纽誽难囁黁狃拈囊嫋拏黏囐嫐囓囔狔囕拗囜軜囝狞嫟拟囡難拧苧嫨苨嫩曩蛪雫嫰拰櫱蛲諵苶鋷廼諾廿拿匁欁弄挊猊挐鼐茑朒霓輗錗匘笚欜錜嬝笝鬞挠猠鬡嬢嬣眤輦鬧弩朩挪嬭伮笯朰伱猱伲嬲眲挵嬺蜺圼錼匿孃卄齈齉譊捏南佞你孥孧齧睨譨鍩孬坭齯獰獳佴孴靵獶魶靹捺孻捻杻蝻孼孽獿宁辇鮎枏鎒辗讘螚掜澝莥鞥侫侬莮農辳鎳垴讷羺莻厼侽鮾掿枿鎿濃矃柅揇寍菍揑濔寕寗濘鯘寜埝篞柟柠鯢寧毭蟯柰鯰迲念忸诺迺叾埿
zhen=甄鴆震挋鬒朕眕紖萙栚缜縝眞贞真昣縥帧砧鸩帪弫振錱圳阵搸椹眹稹診樼甽紾幀鉁轃聄镇浈籈赈獉遉屒酙畛湞桢陣塦潧瑧楨填桭祯瑱葴偵鱵轸絼鍼针禎榐枕蒖袗覙榛禛殝貞斟侦碪誫鎭抮枮鎮溱侲箴辴澵疹纼薽蓁嫃寊诊珍珎賑揕裖胗駗槙針竧姫軫黰鋴臻
o=噢喔嚄哦筽
p=尀逄鐅氆簈瀊堋怌萍砏瀑搒砒怕氕琕頖倗頗耙蠙耚谝鰟萠鐠吡堡萢琣否怦尨頩耪搫砯蠯砰簰谱砲簲破琵怶琶砶鰾塀屁聁汃衃偏屏葐硑摓籓汖聘屛塜鑝呠聠顠葡葩呯顰恲塳呸汸瑸鑻硼豼豾悂咅咆撆鲆撇炇颇梈炋钋袌炍袍蒎鲏炐频貔粕沗袙沛沜璞沠袢墣岥颦肧貧肨蒪被炮岯钯傰炰碰蒰蒱撲蒲邳貵岶肶袶钷璸岼壀品飃僄飄磅賆磇铇擈泊哌铍磐棑鳑裒棓胓僕胖擗飘泙棚胚蓜烞磞瓟賠泡瓢哣裨瓫郫蓬泮胮烰哱蓱郱烳裴裵瓶烹泺铺僻磻泼胼攀洀甁鴄夆攈贌甓礔礕紕椖礗褜礟蔢崥洦焩椪贫锫脬礮脯鄱攴洴脴攵焷甹派脾敀腁楄奅配慓畔赔腗絣啤奤镤鵥浦酦鵧畨票镨楩啪番鵬酺襻慿浿榀妃涄醅禆疈憉疋榌膍嶏妑憑覑覕膖醗妚閛熢鶣醥膨馪覫馮冯喯膰疱醱疲薲趴憵喷馷冸薸趽斾旁跁槃旆闆旇駊駍淎跑駓姘跘嗙釙旚秛淜闝痞淠秠痡闢駢藨凭痭槰跰凴姵緶釽秿鷿騈娉帊鸊蘋嘌縏渒帔丕帕蘕舖舗騗嘙騙鈚娝稝帡昢判樥舥娦刨稫踫阫丬爬嘭爮騯阰帲樸縹鈹舽丿爿扁繁蹁陂湃驃婄婆片幈牉詊幋鉋牌鹏湐扑乒扒蹒乓湓評鉕剖癖噗穙牝驞鉟陠蹣穦陪普穮副平噴湴陴艵批剻噼蹼鉼剽噽庀纀犃芃麃纄皅麅劈骈嚊溌蚍檏犏皏媐抔銔庖嚗骗檘芘抙抛暜庞骠銢犤皤媥溥犥隦亨抨嚩抪披皫嚬庬嚭麭皮庰皰纰媲蚲暴抷媻犻暼蚽蚾溿骿諀滂仆盆櫇狉苉拋拌拍狍嫎嫓狓嫔嫖盘拚曝諞勡蛢盤苤囨苩諩鋪鋬髬竮軯雱髲仳嫳軳廹苹盻拼盼竼髼軿伂漂圃錃猅眅鬅朇錇猈霈匉朋錋匍錍匏缏圑伓笓鬔鼙輣圤缥輧漨嬪眫輫圮漰蜱朴猵霶挷弸笸匹霹猼伾缾捀鍂魄捊潎潑魒荓歕潖捗潘獛譜坡轡坢筢罢靤睥捧佩坪譬彭魮坯彯獱罴彷杷罷魸潽魾箁螃鎃鮃箄鞄羆莆枇枈垉掊殍鮍澎龎厐龐莑排辔螕徘鎜鎞鞞瞟辟瞥箥瞨莩徬玭枰徱掱箳螵玶鞶螷垺澼掽便珀评濆鯆篇柈矉揊翍菐埔俖毗毘蟚叛蟛俜濞蟠篣埤柨翩菩迫柭濮珮毰翲俳叵篷鏷柸翸韸培篺鏺篻濼韼
q=頃蠄頄耆砌逎頎蠐堑逑栔栖瀙倛耝頝逡蠤倩怯蠷蠸耹蠼倾偂硂顅灈硈顉灊桏衐遒恓硗恘硘塙硚硞偢衢遣桤桥灥顦恮确恰顴恷遷顷塸塹聺桼衾颀炁碁梂碃墄悄肍墏悏碏悓傔炔邔傕碕墘墙悛碛邛墝炝肣墧颧梩袪悫梫悭邱袳肵傶炶碶肷袷確墻碻墽悽傾棄郄情烇棈僉棊胊棋壍磍磏僑惓裘裙僛磜磝胠裠胢棤磧棨磩郪惬棬磬郬棲磲壳惸僺郻磽棾愀褀椄礄褄愆礉夋椌焌焏礐脐愒愘礘儙愜儝夝椠夡鄡鄥椦愨焪儬愭焭礭褰鄿煀祁襁奇祇祈慊酋奍煍契兓煔腔祛酠煢慤全煪慬慳其慶奷楸祺慼慽楾膁覃憇憈憌熍憔醔熗醛禥憩榩親覰榷覷妻覻禽冾妾榿懃凄懄燆駆駈凊燋秋秌槍臍槏觑觓槗釚臞懠觠臤釥秦槧燩觩駩槫槭觭釮凵駸釺釻姾訄訅鈆切樈刋騎騏鈐戕訖戗稘鈙戚騚騝刞爠騡戧稧権鈫騫樯戵樵娶券娸騹舼稽牄驅牆橇橋前婍扏穐詓穕鉗剘婘詘橚鉛婜剠艢扦橩艩牫橬詮扱驱扲牵牶牷穷穹牽艽橾劁芁窃媇犈媊芊抋犍窍檎銎骎骐芑骑銓誚誛劝媝犞芞骞檠芡抢檣芩芪劬犬犭銭犮窮犰檱抲誳檶銶芹骹抾檾嫀櫀髂竅竆苆諆竊狋請勍櫏竏竐諐拑竒竘苘髚髜鋟苣勤拤櫦勧勪拪竬諬嫱拳櫵嫶髷勸茄錆挈鬈猉笉權欋猐鬐謒欔茕嬙謙嬛茜鬜鬝欠笡錡錢匤欦謦匧欪欫猰嬱挳欹区欺笻匼欽茾欿鬿區筁千荃孅獇筇孉歉筌魌荍歏譙荞荠卡鍥捦歧荨鍫歬鍬卭孯捲却譴卻魼签卿捿玂鮂掅宆鎆玌莍殎殏掐箐掑殑厒掔鎗玘箘箝箞箧玪讫宭掮厱玱殸厹厺去殻殼鮼箾毃菃鯄寈篋篍诎篏寑鏒鯕取寖鯖鏘鏚鯜寝篟诠珡寢揢菣菦毬篬菬揭诮鏲菳叴寴揵请鏹揿琁萁鰁球搇鐈搉鐉萋鰌氍鰍鐑气萕気搝吢氢吣氣琦谦萩琪氫鰬鰭启簯谯氰鐰簱搴琴谴搶琷谸鰸琹搼琼簽鰽求呇屈豈汋葋鑋鱋籏汓鑓汔瑔摖籖汘呚呛葜葝籡摤籤葥汧籧摪呮摮瑲葲屺葺鑺摼汽呿撁沁粁岂璂璆岍撍钎沏岐岒岓岖璖璚蒛咠钤钦蒨璩撬粬咭鲭鲯钱撳钳岴粸撽泅铅鳅鳈泉瓊鳍擎擏峑擒賕擖瓗糗峠泣峤铨峭峮蓲鳹鳽蔃崅甈唊紌崎攐攑唒攓洓锓锖唘唚锜鴝甠洤紪唭洯攲锲蔳唴锵紶崷蔷锹洽浀畁蕁浅絇赇啌嵌畎蕎啐啓啔蕖浗嵚嵜啟絟敠畦敧啨嵪敪镪鵭鵮嵰敲蕲鵲啳起鵸赹敺赾絿鶀趄綅疆嶇嶈鶈斉斊趋疌鶌趍嶔薔鶖嶜趞嶠綣趣綥趥綦疧斨綨趨斪綪趫喬趬鶬綮喰斳閴綺薺喿緀淁旂跂闃藄跄嗆淇痊闋闎巏藑淒藒跒闕旗跙闙嗛緝巧緧跧嗪跫淭藭藮巯巰嗴跷淸淺藽嘁丂七蘄清踆丌踍昑蘒阒縓且阕丘阙鸜渞丠渠蘠踡阡帢踥踦蘧帩帬鸲縴瘸帹渹阹嘺帺瘽癄湆湇虇繈蹊鹊蹌噐鹐繑幓乔虔陗噙鹙乞蹡繦幧器湫湬虬噭湭陭癯虯繰晴晵湶乹蹺蹻乾繾癿亁庆麇庈蚈躈蚑隑暒麒亓蚔蚗皘蚙蚚亝亟麡暣躣纤溬麮蚯躯麯溱亲皳麴皵麹庼蚼盀軀雀雂蛆仇滊廎蛐廑黔囚盚黚軝仟軡黢軥黥廧蛩蛪蛬绮仱曲蛴盵囷蛷绻軽漀企朁鼁弃朅漆輇圈缉圊霋伎圏朐漒輕蜝蜞期伣蜣輤鼩弮圱缱圲缲圶強蜷蜸伹朹强缺圻蜻缼伽鼽权杄睄罄坅佉彊罊齊潐齐靑青睘靘潛潜杞佢蝤齤佥坥靲齲坵蝵佺蝺轻辁螇龋羌瞏鞐鞒螓羗鞘龜枝龝羟龟羣群羥鞦瞧螧鞧侨鞩枪羫羬侵螶羻螼鞽澿瞿迁忂迄俅埆韆迉俏韏埐翑柒韒俔忔矔蟗翘矜濝矝蟝俟埢埥濪忯濳忴矵翵翹埼矼蟿
qian=朁愆鈆唊刋攐鈐堑攑攓儙謙騚茜鬜騝鬝椠欠阡錢伣輤欦谦倩騫鰬褰圱嬱缱圲挳蔳搴縴谴蜸谸簽茾欿蕁偂千杄孅浅顅歉慊灊嵌前鹐鑓煔虔籖鉗汘潛鉛婜潜遣籤佥葥扦汧荨橬歬鵮孯嵰扲慳譴牵奷遷乹塹摼牽乾签繾亁撁粁膁掅鎆蚈媊芊岍撍犍钎岒悓傔掔墘皘蚙箝骞芡纤钤蒨榩玪綪羬悭銭掮厱钱钳檶炶肷迁铅韆棈僉壍槏櫏磏竏篏諐拑俔黔黚嗛仟篟軡臤槧拪仱鏲濳忴凵揵淺釺鳽
yuan=渁縁圆渆渊鼋圎笎蜎褑園茒圓渕夗缘鼘鴛圜謜鼝贠眢鸢褤怨猨鈨爰弲鸳蜵騵逺嬽愿猿灁元轅剈衏鹓瑗员願酛蝝遠院楥塬杬魭噮蝯湲鵷橼葾悁袁沅傆円螈邍源禐溒辕蚖薗肙喛媛宛蒝榞原貟厡箢鶢垣冤妧邧芫榬蒬鶰羱鎱薳妴媴涴厵垸掾寃嫄惌駌苑远櫞員緣囦棩裫园援淵盶鳶裷鋺黿
qiao=愀丂礄鐈礉踍頝鄡鄥帩谯鐰缲樵锹嘺癄睄橇橋煍荍蕎潐繑幓乔硗陗譙硚荞偢桥顦幧嵪鍫鍬噭摮繰敲蹺蹻橾劁悄躈窍鞒憔鞘誚墝犞嶠墧瞧侨鞩趫喬撬趬骹殻碻殼墽撽鞽箾喿雀毃竅燆燋俏僑鏒韒槗翘髚髜磝峤釥巧勪菬峭藮诮壳櫵嫶跷翹僺郻磽
r=蘂刃渃爃蘃刄栄氄娆爇鰇搈戎耎搑蠑訒鈓稔蠕渘蘘爙縙鰙氜瀜縟栠栣帤鈤騥堧渪嘫阮鰯吺瀼穁蹂穃偄桇葇橈瑈偌瑌橍繎扔扖穘汝瑞繞繠桡瑢牣穣橤呥扨橪顬鱬汭扰穰驲乳桵衵遶屻繻衻婼衽陾媃岃嚅蒅媆傇袇粈肉撋蚋銋認抐梕纕肕肗蒘邚傛肜碝躟袡芢隢媣銣颥蚦纫芮肰銳纴袵躵媶溶嚷媷人蚺亻蒻檽溽袽芿瓀仁糅嫆瓇蓉壌仍蓐绒苒軔绕壖曘仞軟壡惢壤瓤若髥曧狨擩飪壬仭热鋭棯髯鳰峵軵勷铷囸惹任苼擾烿鄀餁嬈紉朊笍鄏挐锐鴑儒攘茙缛脜礝紝褣甤鬤褥嬫焫嬬輭輮弱朲洳儴然茸茹蜹挼礽鴽鵀杁坈楉兊蕊蕋兌祍絍腍筎荏兑杒鍒饒襓镕嵘蕘蝚荛魜腝蕠蝡煣荣嵤潤蕤入襦絨饪轫腬靭软靱譲女獳譳荵嵶饶孺楺捼獽蝾睿如宂冄冉妊宍融螎喏閏讓熔鎔鶔榕冗枘綛侞閠羢鞣瞤认润让箬榮熯熱讱辱禳榵膶薷嶸禸辸鶸厹容醹馹嶿秂燃珃忈揉姌緌韌忍菍忎叒染柔嗕韖姙篛緛叡濡日駥槦毧韧釰闰鏸懹秹釼
cu=鼀麁徂殂促瘄麄麆簇噈趋醋誎卒觕粗趗蹙怚猝蔟趣顣麤踧媨脨趨縬瘯憱蹴蹵橻皻踿
s=送鐁怂瀃吅鐆谇氉簌頌損搎琐琑簑瀒鰓搔簔砕琗耛搜栜耜思速倠鰠搡瀡谡逤簨萨鐩倯耸簺尿遀遂摉摋顋摌摍塐鱐塑桑灑桒籔恖摗顙汜塞瑟遡鱢瑣桫遬偲聳摵硹梀傁岁傂肂颂傃肃邃貄璅肅肆碎蒐钑撒撕傘悚璛粛蒜咝傞粟颡梢粣梥撨梩梭颯傱璱璲颸颼颾碿泀蓀糁磃蓃鳃棇磉飋鳋擌瓍蓑飒飔飕泗泝糝擞食惢糣泤糤飤賥僧泧飧壭森铯飱僳棴飴棷哸糸糹擻飼賽僿锁攃唆夊鄋蔌洍脎洒洓餗夙洠素愡唢愢索甦崧褨儩愫愬洬褬椮愯锶餸锼餿祀襂慅饊楒兕嵗祘襚赛祟散楤酥嵩慫煫啬蕬腮蕯絲饲蕵嵷酸蕼浽膆馊綏閐涑馓薔趖禗覗涘醙趚薞憟禠榡熣涩禩薩喪閪榫禭薮斯喰膸榹馺憽鶽凁私槂懆凇嗇嗉臊嗍燍懎姒嗓嗖藗凘旞淞闟駟痠槡嗣鷥嗦緦燧嗩藪觫鷫槭嗮槮釲巳駷嗺嗽嗾娀騃蘇三渋樎娑縒鈒騒蘓樕縗瘙丝娞訟稡稣縤嘥騦丧騪縮訯娰帴訴嘶瘶鈶鸶瘷騷鈻所繀穂繅穌驌繐穑虒鹔繖穗艘橚蹜噝穟穡扫繬牭穯繰鉰色驷繸乺噻扻虽銉隋随溑芕骕亖檖亗犙纚骚些暛溞纟躠隡窣媤誦檧隧隨銫溯銯溲誶溸溹庺隼廀嫂髄嫅鋉嫊廋囌苏仐櫒髓滖鋖雖四廝髞櫢竢绥竦廧仨雭櫯狲蛳拺狻鬆笇笋缌弎漎謖鬖嬘鬙伞缞蜤笥缩缫眭圱挱挲缲匴欶蜶鼶伺猻似佀獀睃卅譅筍捒獕轖孙潚捜损睟孠睢譢潥荪孫杫筭歮歰歲歳罳潵鍶靸死荽松荾枀澀厁澁掃螄鞈玊宋螋澌瞍鎍莎莏殐鎖鞖算鎟価莤螦羧鎨枩鎪厮箰枱厶鎹掻澻鎻鮻讼宿叁鏁参矂鯂參叄叅濇濉诉鏉揌濍濏鏒揔俕蟖俗柗菘叜俟叟珟毢韢埣鯣忪俬蟴毵诵柶毶司毸鏸篹寺鏼埽鏾毿
t=退态堂逃堍倎透倓耓途逖堗怗倘通倜栝怢砣砤耥頭頲堶逷怹頹頺砼頽桃顃偅遆聉桋塌恌題偍聎桐聑偒塔衕塗塘灘灙停遝塡遢聤硧填恬桯聴桶偷偸恸塼聼聽梃邆悇袉颋悌梌傏悐袒邒颓墖题傝條碢墤傥墥袥炭碮梯墰邰炱颱炲碳墵炵碵梼肽墿悿烃磃磄壇僋胋磌胎僓惔烔惕惖壜棠僣棣飥飩裪烫僮郯飳烴烶飸飻裼惿脁餂儃褅褆餇愉鄌儓愓褖焞褟脡脦大天太褪脫椭餮儯脱夲夳头夵餹儻饀祂奃饄慆腆態兎祒煓兔楕饕套慝酞慟楟酟酡襢奤饦祧饨酮腯慱兲酴奵她祹煺煻腾腿榃覃醄憅膅醈醍醓禔榙憛膛覜憞禟馟禢醣妥熥覥膧冭膯醰馱馲憳榳妵禵榶憻榻禿臀燂凃秃槄駄臋觍燑槖駘燙駝駞駣燤駦槫秱釷凸臺駼駾戃稊騊樋稌討舑舔舕娗託樘舚騠爣樤舦鈦娧騨鈯騰戻剃鉄艇鉈橐詑婒驒剔橔婖橖鉖驖托穜詜橝驝牠扡橢驣橦穨鉭驮鉵婷詷剸特驼橽婾檀芀骀突媂誂銅犆誊劏誔投窕銕芚銚銛犝媞抟媠檡抬抭媮檮檯骰窱檲窴骵誻銻銽骽調鋀談鋌嫍狏苐拓苔體拕苕拖鋖鋚童狧狪諪髫勭髰鋱鋵嫷鋾鬀謄鬄匋挑錔謕挞謟錟笤嬥挩錪挮嬯猯笹挺茼捅捈魋歎鍎荑歒筒鍗譚捝獞譠魠孡筡魨筩獭鍮筳譶捸獺荼鮀它殄厅箈讉鎉宊莌掏鮐鎑鎕厗鮙厛莛探殢鎥掦鮦宨推箨讨讬掭鎲莵鮵鮷鏄珆鯈提篖鏜菟揣毤揥叨揬菭毯台珶鯷叹毻菼珽毾菾篿氃调萄谈鐋同吐萔鰖萚萜吞琠鐡鰧搨鰨搪听谭搯尵鐵搷鰷氽汀瑅屇屉籉摊籊汏籐呑汑摕葖籘豘豚屜籜屟屠汢汤摥呫瑫瑭屯汰汱瑱摶葶瑹鲀钂咃钍粏鲐貒沓鲖貚钛咜粜粡蒤鲦岧貪岮璮沰撱沱沲璳咷岹沺撻貼钽钿鳀铁峂哃糃铊瓋蓎鳎峒糖蓚糛铜峝賟擡铤铦蓧蓨蓪铫泰糰铴糶蓷峹擹铽擿崉唋紏唐锑鴕甛甜攤贪鴫锬洮田贴甸崹唺町甼紽唾紾啁嵉畋镋鵌啍鵎啑畑啕镗啚鵚絛蕛鵜嵞嵣絧敨赨絩赯統啴浵鵵啺啼畽嶀涂綂疃趃斄綈涋綎涏涒趒涕鶗薙鶙薚涛嶞趟鶟斢趧涭閮綯趯涶鶶薹疼涾趿嗁緂跅跆鷆鷈鷉痋鷋淌痌跎鷏闐痑嗒闒鷒跕淘痛闛痜淟闟藤鷤闥闧旫藫藬痰緰旲跳嗵鷵痶緹添鷻闼旽嗿跿蘀嘆蘈瘏踏帑帖阗阘昙縚渟嘡縢踢蘣阤渧縧瘫鸵踼嘽嘾晀陀陁蹄虅蹆乇鹈湉噋蹋幍晍湍蹏幐蹚湠湥晪湪蹪湯癱繵陶蹹庁躂嚃庉庍嚏溏蚒嚔溙溚隚庝亠躢庣隤庩亭庭躰庹嚺暺躺溻暾軆曇黇曈蛈黈蛌滔滕他黗軘仛廜仝统团団囤绦绨滩曭廰囲図廳廷盷绹蛻囼图替霆缇鼉鼍朑朓蜓圕蜕霕伖圖圗鼗團漙弚漛朜鼞土弟漟鼟圡圢弢朣眣鼧蜩蜪眮鼮漯霯鼵朷弹眺漽弾轁佃彈罈坉坍罎蝏体睓杔靔彖佗坛杝靝佟齠条坣彤罤坦坨蝪潬潭坮潳彵佻潼睼鞀螁侂龆鞈鞉垌徒鞓侗螗鞗鞜螣侤徥羰侱枱鞱徲瞳螳鞳侹澹鞺侻澾俀柁忊濌迌濎忐忑忒忕矘蟘韜忝柝迢濤韬埮迯埱忲忳俶
x=蠁項須瀉砉蠉选逊頊蠍逍蠏栒倖栖瀗栙瀟校瀣瀥性栧蠨栩怬怰怴蠵怸血恂恄衅塇恊衋行硍硎遐硒衒恓聓恔衔偕顕桖硖衖顖衘遜硝偞恟聟硣塤恤硤灥偦灦顨塪桪塮息顯偰偱灱灲桸選项灺衺须顼邂傄悉颉梋墍碏傒悕袕肖袖炘傚邜墟梟炠邢邤炧炨袨邪炫悬碬颬袭械颴颵肸碹肹梺悻碿僁惁胁飁郄烅壆裇郇郉僊烋郋烌烍磍飍壎磎像壏壐惐僖郗胘烚惜烜惞郤胥壦飨僩郩烯僲烲想僴磶胷郷胸惺壻烼裼焁礂愃焄夅脅儇焇脇焈褉鄉餉鄊愋脋焎褎鄎夏褏餏夐夑夓夕鄕愖脙椞焟餡礥鄦脩鄩脪焬焮餳儴儶愶焸椺愻褻褼餼焽愾慀兄祄襄酅煆祆兇煇先楈饈慉奊煊腊煋饎襐契襑楔煕酗饗奚奞饟楥祥腥楦煦饧饩祫襭兮酰襲襳兴饷腺饻奾楿西熁熂熄馅熇熈熊禊熋見榍膎醎熏馐禑醑禒醒冔憘写憙熙香榝膝妡覡憢禤膤覤馦禧馨冩憪馫榭膮醯憲馴妶醶膷憸馸熹熺醺熻冼禼榽熽秀姁懁见釁燅懈秈觋槏臐釐槒姓臔燖臖懗凞觟姠懢槢燢姣解臤觧燨駨觪姭臭燮姰燲觲釳凶觷懸燸釸燹臹觹姺燻臽觽駽觿稀騂舃鈃稄舄樇興娊訊鈊爋舋戌娎戏訏刑爓訓爔爕娙訙舝訢鈢騢訤稥樧稧樨訩訫娭戯樰稰戱許騱戲樳娴稴舷券稸娹訹舺騽舾橀鉉驉削婋橌驍詗穘艝婞橡詡扢詢驤詨鉨驨鉩驯婱扱橲詳穴鉶扸穸橺牺詾婿犀骁檄銄檈銊骍芎芐銑誒銒犔媗芗銗窙銛銜銝媟誟犠誢劦犧芧骧窨媭芯媳誵銷窸誸効銹骹銽鋅髇勋苋嫌狌狎髐諕勖勗鋗狘嫙勛狝諝鋞諠髤狥諧鋧勨苬狭苮勰諰勲勳諴櫶狶勷拹櫹狹髹嫺嫻諼諿欀匂嬃猃謃嬆猇匈嬉錎謏嬐笑謑茓謔笚鬚嬛嬜謝挟匣欣挦欦欨猩鬩欪錫献欯欰猲謵欷匸嬹欻挾荀鍁卂譃孅筅歆譆魆歇荇孈魈歊卌鍌协協歔歖魖歗歘孙歙鍜孝獝孞譞獟獡獢譣卥荥学獦卨荨筪孫獫獬獮獯筱卸學卹鍹獻魻捾筿厀掀鎀玁讂莃玄殈殉鎋鮏莕讗莘掝鮝厢宣厦莦莧宪箫训鮭箮鮮宯讯现箱箲鎴鮴宵箵莶许玹掺玺讻鎼殽殾箾县宿篂鏅诇鏇毊揎鯑揗珗鯗叙珛珝揟篠询珣毥菥鏥珦详毨珨诩寫珬鏬鏭揱揳叶诶鯹寻鏽現鏾吁琁琄吅琇鐊尋琋鐌小谐向谑吓鰓鐔鰕谖簘氙搚鰚谞尟搟尠谢氥萧簫萫萱萲吷吸携谺鰼谿豀鑂屃鱃瑄瑆葈鱈鱌瑎豏鱏汐鑐屑屓瑕葕屖鱘葙鱚汛鱜屟摡象屣鑦屧豨鑫呬屭鱮豯鑲屳呴鑴鱶呷葸汹呺摻鱻籼汿沀咁貅蒆璇撊撏钑鲑璓璕貕岘钘鲜咞粞鲞鲟蒠蒣岤咥撨岫咭粯咰咲蒵撷咸咺咻璽璿峀峃鳃泄蓄哅蓆糈賉铉峋响糏铏蓒哓糔擕瓕鳕瓖哘鳛峡賢铣擤糦铦瓨峫泫泬哮糮哯賯蓰蓲峴泶擷泻系峽蓿销紃崄攇锈甉唌锌唏洐洒贒攕洗蔙贙攜鴞锡崤贤洨锨洩洫唬細紲攳洵鴵洶唽蕁鵂畃絃效蕈啍敍絏浒浔鵗敘浚畜絜镟嵠浠镡絢啣絤赥蕦敩赩絬蕭敮絮蕮赮絴镶啸蕸敻赻蕿涀薂綃斅綅斆綇趇斈消綉綊綌薌嶍涍涎喐趐嶑閑閒閕綖趘続喛薛喜斜疜閜疞薟薢喣薤疦喧閧嶨疨薪閪綫薫涬嶮嶰新薰鶱嶲疶鶷喺鶽巂闂嗃痃藃嗅淅淆緆巇藇緈嗋旋鷍緒藓緖藖緗痚線藚嗛藛痟闟巠巡淢跣緤旪痫旬旭跭緰闲緳鷳旴鷴巷跹巺藼鷼巽鷽縀鸂縃踃丅踅下嘋阋希昍蘍嘐蘐渓昔嘕昕瘕縖嘘縘蘚瘜星阠昡縣嘨昫渫席鸮嘯縰渲鸴嘵鸺嘻嘼縼显噀晅晇癇鹇虈陉繊蹊繍降癎噏湏繏限晑湑噓晓虓虗湘陘噚虚晛虛陜蹝晞习乡繡癣乤繥陥噧虩险繫癬蹮幰晰噱繲虲晳乴噷陷幸鹹噺湺険虾陿暁纁蚃暄暅溆嚇暇纈嚊暊續纎序嚑溓纕纖麘皙隙麙纚躚些皛躞隟庠躠嚡皢嚣纤庥躧庨皨溪險享暬蚬嚮亯隰嚱麲溴亵隵暶暹嚻蚼暿线蚿滀绁囂廂雄细廈滈曉滊囍滎曏曐軐軒黖仙仚绚曛蛝廞囟雟黠绡蛡盢绣绤曦廨盨绪雪滫续雭廯盱廵蛵盷滸相蛸盺盻需省蜁朂缃霄蜆漇伈県朐缐休眗漝霞蜥弦伨伩圩漩眩霫缬伭霰輱弲伳眴伵漵圷缷鼷鼸霼朽缿齂坃潃睄轄罅齅彇潇杊潊轌睍睎蝎杏彐蝑潒蝖齘齛潝潟潠佡彡形蝢齥蝦轩杫佭潯睱睲杴靴坹杺睻靾侀瞁螅徆徇螇羊型鞋瞎羏侐徐析螑枔澖辖徙澙鞙侚羛螛辛羞侠羡徢鞢龤垥澥辥徦瞦羨澩循辪羬枭枮徯瞯枲瞲羲枵鞵垶垷枻侾鞾垿忀係蟂心忄矄迅韅俆翈埉蟋矎俏蟏習翓蟓翔翕矖翖韘俙埙柙忚翛矞俠信俢蟢忥翧蟫濬修韯蟰韰韱俲埳蟳忷蟹忺忻俽矽忾翾迿響
z=簀鰂搃倅栆吇蠈簉倊尊搊蠌怍怎鐏耔鐕谘怚鐟造琢栥鰦倧簪堫栫耫栬簮谮吱倳瀳砸总栽頾頿鑁灂葃汄葄葅灒鱒葘做桚鑚鱛塟摠鱡恣籫偬葬遭呰呲側豵遵灶偺葼災籽鑽灾鑿咀咂碂璅咋撍梍袏梓璔咗増鲗撙岝沝增岞沞沢粢傤咨蒩璪墫責傮撮傯沯鲰咱貲袸邹璻钻鲻粽璾擇資哉瓉糉賊糌賍泎胏瓒僔胔棕烖棗蓗賘胙蓙瓚賛糟鳟惣哫磫糭郰磳糳賳飵棷棸賺蓻泽惾胾賾锃攅洅贈椊贊礋儎紎脏唑甑鄑崒攒鄒洓贓椔唕贜攢唣责攥紥儧焧唨崪紫鄫紮崰崱锱蔵唶椶蔶儹鄹贼鄼崽甾赀兂酂赃镃組资酇絊襍奏嵏酔嵕祖襗奘啙腙祚赜蕞赞镞畠赠饡酢鵤慥啧酨啫嵫煰走楱赱嵸襸兹酻赼祽鶅醉嶊薋禌再憎鶎趑喒熜綜嶟榟冣趦熧醩疭趮趱趲足嶵禶熷薻喿緃淄秄緅緇姉姊族総藏臓駔姕緕槜臜觜嗞租臟臢燥左臧秨釨早燪自緫嗭秭緵秶鷷嗺藻凿姿帀縂昃稄樅鸅騌樍渍稓嘖昗则戝昝稡縡騣踤縦昨踨踪嘬鈭昮稯縱瘲嘴舴稵樶騶帻阻爼鈼阼樽渽總訾訿艁噂牂噆鉆則噈繌扎繒繓蹔鉔扗幘剚詛繜穝繤蹤橧蹧噪晬陬穳橴橵驵牸虸驺湽噿皁躁庂抂暂皂纂纃檇纉檌銌芓骔劗纗纘躜択皟蚤躦座溨暫溭媰纵銺黀囃竃仄组竈囋滋从囎諎諏囐雑髒滓仔滜雜鋥雥嫧择髭諮竲苲拵拶鋷综曽曾最缁鬃欈茈弉載鬉茊錊鼒猔朘錙輜匝朡茡猣眥眦匨在笫漬笮謮缯茲缵鬵鬷輺錾潀杂譄卆罇潈杍齍佐坐子譐鍐捑卒孖譖字捘齚作孜齜睟譟荢潨睪罪蝬筰齰齱孳魳捴歵睵孶齺靻捽载罾鍿箃讃玆龇莋辎鎐瞔宗羘讚厜從枞辠澡鎡枣澤箤箦侧掫澬宰侳鎺寁鏃诅菆珇迊揍俎鯐菑揔鯔蟕揝柞矠濢柤鏨鏩翪鯫柮迮鯮矰韴矷篸篹菹诹鯼濽
da=鎉羍咑鞑匒沓眔龖撘薘龘憚溚笚怛鎝炟褡亣大瘩笪搭垯妲墶耷逹鐽达韃荅汏迏哒嗒打答達迖畗荙詚迚噠畣繨惮剳燵跶靼蟽呾
dia=嗲
die=疂趃鰈疉疊耊喋耋褋谍氎挕戜殜堞碟怢鞢眣垤咥蜨鴩眰螲昳爹褺崼鲽蹀牃詄胅泆幉哋峌跌恎啑牒艓跕绖佚諜瓞叠曡槢柣楪迭跮絰揲畳惵苵蝶臷镻軼嵽
de=鍀淂的惪蚮棏地徳悳旳恴底得德嘚锝
jun=袀儁銁馂碅麇攈焌骏麏蚐餕麕箘莙军君龜鈞銞攟箟龟蜠覠钧鲪皲頵鮶皸皹隽呁捃均燇埈俊雋菌軍懏賐鵔鍕鵕陖鵘晙浚棞筠郡竣濬汮寯畯姰葰珺峻桾駿
rong=宂爃栄氄傇搈融戎螎搑蠑熔鎔榕冗縙茙傛瀜肜羢褣嬫榮榵媶溶嶸茸容穁穃嫆坈蓉绒镕嵘瑢荣嵤駥槦曧毧狨絨峵軵蝾烿
di=嘀樀甋蔋焍氐蔐鸐递逓缔頔蔕唙笛谛帝弟怟娣堤弤砥渧第地眱踶阺奃蝃詆遆啇睇敌低坔摕杕坘偙扚聜镝遞浟蹢腣呧鉪蝭靮遰啲楴牴籴豴敵祶慸坻荻嵽彽嚁媂蒂的隄墆趆梊掋厎疐墑枑梑肑玓底禘袛羝枤涤墬碮螮鞮馰碲嶳抵骶邸岻覿僀菂狄埅埊哋诋滌觌提苐鏑苖觝埞拞翟諟締嫡藡柢髢棣俤揥諦菧蓧軧秪迪釱旳鯳滴篴糴珶廸仾磾
ning=嚀宁矃鸋寍聍鑏寕寗濘咛儜寜凝澝佞泞狞柠鬡嬣橣寧拧苧侫甯擰獰薴檸聹倿
bei=昁鄁鞁愂唄箄备辈憊倍椑碑犕悖梖誖北備焙禙褙碚貝贝鞞钡輩被悲琲庳骳鞴邶鐾諀臂陂僃勃盃鋇狈背鹎卑棑糒棓蓓呗孛偝苝藣郥惫牬杮桮杯鵯軰鉳柸偹揹俻珼狽蛽
ben=渀賁炃犇翉坋坌楍泍奔奙畚錛锛栟蟦笨逩撪本喯夯苯漰夲贲桳倴捹
gou=撀构搆耇耈耉傋鈎缑冓溝够沟夠褠垢岣袧钩购覯笱鞲芶枸簼蚼玽訽媾彀痀啂雊構觏糓狗拘遘佝篝韝苟诟姤鉤句詬緱呴坸煹購勾豿
zui=咀最檇欈醉嶊絊錊檌酔蟕纗朘厜槜觜蕞睟辠稡濢冣罪晬栬嘴嶵樶鋷嗺璻酻祽噿
diu=丢铥銩颩丟
gong=輁紅侊鞏龏匑澒弓匔龔熕龚供唝功贡红貢蚣愩宫躬宮栱肱躳厷攻碽羾銾嗊幊慐珙杛汞篢工觥塨巩公恭共拱拲觵髸糼廾糿
tie=鐡铁僣鉄蛈呫餮聑贴跕銕鐵帖驖怗飻萜貼
du=讀斁笃瀆阇犊渎暏芏醏妒贕錖螙肚涜嘟椟讟渡犢度蠧覩妬殬読殰騳匵堵蠹嬻琽厾皾镀瓄豄韇赌牍鍍闍髑毒牘杜櫝凟鑟剢督韣姤篤韥獨黩独賭靯荰晵黷睹秺竺裻读都
zuan=纂繤攥躦鉆纉籫缵劗纘篹賺鑚钻躜揝鑽
zun=噂罇尊墫栫銌鶎鐏譐鱒瀳僔拵遵鷷捘袸撙繜樽嶟鳟
zuo=葃葄莋怍諎袏佐坐唑稓繓咗胙蓙做祚作岝穝岞柞琢酢左座昨秨嘬撮柮笮筰苲侳糳飵鈼阼捽
jve=鴂鴃戄砄鈌鐍爑氒倔刔挗瘚崛爝鐝弡訣崫攫欮谲焳爴爵匷吷噊灍譎彏孒孓捔絕獗噘繘橛橜蕝镢蕨屩屫噱穱虳瑴絶蹶桷蹷決赽钁劂玃亅撅抉趉斍覐傕蚗掘璚覚妜貜憠嶡厥嶥熦玦疦袦撧玨躩憰决誳芵趹覺嚼诀駃臄埆壆觉髉燋矍珏角叕觖鳜绝矞矡鷢蟨蟩泬櫭觮觼
pai=沠湃鎃犤箄猅輫迫哌牌拍蒎簰棑排渒簲俳徘廹派
ren=餁刃岃刄紉妊銋認訒鈓稔梕肕綛紝栠芢栣认纫讱朲纴袵躵人亻鵀仁秂忈韌忍祍絍腍菍忎荏杒軔姙魜仞牣韧扨飪饪轫壬仭靭棯釰靱荵秹任屻釼衽
pan=攀洀眅瀊炍縏頖沜鎜萠袢判肨搫眫丬膰蒰鞶冸媻溿爿聁槃闆柈牉詊幋拌磐蹒籓畔胖潘盘跘拚叛蟠坢蹣盤鵥畨番鋬泮湴盻磻襻鑻盼
cha=疀紁芆馇鎈梌嚓岔侘垞銟檫茬喳碴茶餷锸刹猹搽挿楂秅蹅捈杈叉汊剎槎嗏插鑔嵖摖艖仛偛察扠鍤查詧诧衩詫靫差扱镲苴揷姹査奼臿
pao=跁麃鞄奅麅咆铇垉拋鉋袌狍袍匏跑庖嚗抛褜瓟礟泡萢靤刨藨脬麭炮爮礮穮炰烰皰疱砲軳
che=聅澈揊車焎唓偖砗莗頙迠伡爡烢掣撤俥撦车硨硩呫屮瞮扯摰奲烲勶徹尺彻坼蛼
keng=揁硁劥坈阬吭坑挳妔銵鏗殸誙硻摼牼硜鍞铿
ei=誒诶欸
chi=持吃樆瘈茌謘匙眙弛瘛耛笞踟鴟攡漦褫伬鸱眵訵尺耻欼佁湁筂噄鵄遅捇豉鍉呎荎魑齒奓鉓敕慗杘摛恜齝腟遟池扡癡赤恥彨遫饬噭歭歯驰彲遲彳卶慸鉹絺啻坻灻赿齿墀誃蚇侈箈邌箎憏銐垑鶒肔鶗侙鶙粚妛瞝斥殦蚩趩喫螭徲袲蚳袳馳抶沶麶媸傺誺炽熾貾翄勅柅翅狋黐勑懘鷘迟迡柢跢胣嗤翤哧翨篪菭裭飭叱痴雴胵拸痸叺瓻烾竾俿
en=奀摁恩蒽峎煾嗯
sha=猀砂粆儍莎霎萐箑紗沙榝喢厦唦樧鲨鎩閯挱纱蔱挲閷刹帹殺傻唼倽杀歃嗄廈濈杉鯊摋鯋剎啑翜煞裟翣啥魦痧菨铩桬毮歰硰乷繺髿
er=誀輀邇二而餌弍洏耏弐尒尓尔侕梕鲕鮞咡粫栭隭栮貮鴯贰趰洱唲樲耳貳刵鸸袻爾薾儿衈荋峏聏児陑兒杒铒轜珥毦迩駬佴饵髵髶胹鉺
chu=岀处锄禇躇儊榋亍刍蜍礎趎搐鄐犓躕傗樗椘貙檚褚初耝耡蒢閦储厨助欪炪蒭媰儲璴怵鶵斶憷芻嘼滀础絀滁臅菆慉櫉敊濋竌绌泏鉏雏竐諔處櫖豖矗廚楚雛歜畜黜豠摢齣鋤除櫥処触篨齭幮楮蹰埱橱摴杵蟵俶藸觸出橻齼珿
she=蠂射欇阇騇涉渉輋舌厍舍舎蔎挕折厙攝麝猞檨設涻弽社设摂摄灄蛇赊闍泏慑賒奓賖佘韘歙滠奢蛥赦捨畬畭揲畲慴虵磼懾拾
sang=搡桑槡颡桒嗓丧磉顙喪褬鎟
shi=市适栅耆师氏舐舓世丗嘘鰘逝鰣鰤鸤谥師簭是昰鈰尸戺栻恀時籂鉂恃鉃鉇遈屍屎鉐塒噓硕豕湜呞瑡湤試乨呩詩適噬乭虱驶葹鉽遾湿蚀亊事蒒誓蒔檡溡鲥碩溮貰銴咶鲺炻溼势邿什铈竍蓍烒仕峕峙諟食飠諡勢狧士拭狮鳲狶泽拾軾飾鳾惿眂眎式弑弒嬕匙餙謚餝眡鼫鼭失贳笶褷示崻礻似崼十絁獅浉卋祏蝕睗兘識饣畤鍦蝨啫襫奭筮饰楴嵵煶襹轼酾使榁侍厔殖視鮖实冟実室澤徥澨宩螫榯宲莳醳鶳馶箷辻施枾釃视识釈释始釋痑揓寔忕濕试诗埘駛嗜矢觢實忯史秲石鯴埶时釶旹柹姼柿
fa=阀姂彂瞂橃藅鍅灋浌乏筏伐珐发法醗罚峜砝蕟傠垡墢閥笩髪髮栰罰佱醱沷茷罸冹坺琺疺発發
leng=愣塄唥堎倰碐薐棱睖冷崚稜踜楞
shu=蜀焂鄃攄踈尌稌戍倏倐树舒紓霔贖尗樞鼠琡鼡蔬瀭朮术錰朱漱蠴儵怷怸輸樹潄摅捈絉婌豎赎陎捒術籔恕荗癙属束襡鉥书腧鵨襩兪虪鱪屬孰数鱰署數杸瑹潻塾橾綀蒁隃墅悆殊疋澍疎暏疏鶐暑抒掓输鮛熟枢蒣薥沭薯咰梳殳庶侸璹庻纾裋黍淑叔濖竖軗曙姝俞鏣竪秫忬糬緰述藷書毹毺菽跾
fo=坲仸佛梻仏
fou=炰鴀紑殕否缶缹妚缻雬不
fu=尃稃訃砆鈇琈娐鰒帗縛刜阜阝氟簠怤砩稪怫頫萯父嘸踾栿乀艀癁詂附幅呋葍婏呒払鉘虙鉜幞婦豧偩衭副桴艴乶扶驸纀傅咈鲋媍咐抙芙抚袚府袝邞負芣肤炥蚥蚨麩岪撫颫麬粰颰袱麱璷麸蚹芾拂绂鳆峊拊绋竎滏糐胕蛗付盙郙郛賦鳧諨鳬泭烰蓲棴髴哹鳺苻賻黻黼茀蜅複蜉复服伏匐洑嬔褔輔鴔伕弗缚鄜负弣焤符椨紨夫甫脯茯笰椱紱鬴甶輹輻紼荂襆畉捊赋畐腐腑鍑祓祔畗罘赙孚佛蝜酜筟蝠鍢絥襥罦蕧鵩捬浮蝮荴赴孵敷腹坿彿箁覄鮄辅覆妇妋綍枎福辐榑綒鮒宓澓垘箙膚鶝玞禣讣馥斧冨復莩涪鮲玸枹垺趺姇翇旉俌富韍柎菔跗俘駙俛釜釡韨凫柫柭緮俯懯巿秿
tang=堂钂戃膅鐋鄌傏劏溏唐帑愓鎕伖螗倘樘薚隚膛鼞漟禟趟嘡爣醣傥耥搪羰鎲螳榶鶶餹躺鞺儻踼糃磄饄镋淌蓎偒橖篖糖镗塘矘灙燙蹚糛闛鏜棠坣嵣汤摥蝪烫曭瑭湯赯铴啺煻
ding=丁顁訂頂仃帄碇钉忊蝊酊鋌濎玎鼎鼑疔椗釘定腚掟碠錠薡聢订萣飣鐤铤饤靪锭叮盯虰矴奵耵啶顶磸町甼艼嵿
yun=匀昀眃鄆贇缊蘊縕鄖鈗耘紜縜伝褞愠贠霣愪餫阭氲氳耺夽允煇畇運慍橒蕓孕晕员酝赟筠陨腪奫齫蕰齳煴蕴蝹荺筼恽煾蒀薀沄榅熅暈熉傊抎澐云殒涒蒕隕醖喗妘殞醞枟貟涢抣玧馧熨纭鞰溳蒷芸馻菀狁鋆秐运磒郓篔韗韞員郧囩韫賱惲雲藴韵緷勻韻緼
ga=嘠魀钆軋尬玍嘎旮朒釓尕咖噶錷夹尜伽夾
ge=搁阁各鲄嘅愅亇箇紇合戈膈鞈個匌挌謌颌肐鎑戓隔騔茖鎘疙鴚閣吤閤纥鮥戨个圪咯鮯猲鬲笴犵輵鎶鞷舸格袼骼鸽搿鴿彁呄槅滆臈镉櫊敋蓋歌硌韐滒蛒裓轕盖韚葛嗝仡觡扢蛤哥塥獦革佫牫铬佮嗰擱割胳臵饹鉻虼諽哿
yve=枂樂岄約悅鈅阅抈月戉越躍栎蚎蚏鸑刖鸙爚妜龠粤玥蘥钥龥悦约說説趯閱閲嬳岳禴粵瀹箹钺嶽樾礿跀跃矆籆兊兌軏乐兑臒哕篗啘扚鉞櫟籥噦黦泧曰籰鑰恱曱矱捳说髺擽楽哾
sheng=省縄殅昇椉娍渑斘笙眚琞生澠枡圣甥阩鼪墭憴殸甸貹榺焺渻蕂珄升繉嵊狌鉎呏竔聖乗偗乘盛胜勝譝陞晟鍟晠湦剩泩繩剰声牲聲橳绳賸陹曻苼鵿
gu=唂唃夃堌縎嘏稒崓鼓瀔鼔怘笟锢鴣逧鸪崮錮估蠱愲鈲尳脵餶谷鈷贾穀詁轂故啒鹘杚罛罟扢孤酤顧汩橭牯呱轱祻顾牿抇馉箍梏咕鮕榖羖箛辜股薣傦骨钴鲴皷鶻皼沽瞽榾毂诂蛄凅磆菇蓇雇淈賈蛊臌櫎篐姑泒糓嗗觚棝鯝古柧巬盬巭菰僱軱濲軲嫴固痼苽
ying=夃爃瀅蠅甇縈攍謍鸎眏贏茔攖甖霙鸚瀛鐛映朠瀠蘡嘤萤愥营萦缨鴬褮瀯礯嬰樱蠳锳嬴瀴頴渶焸耺焽萾瘿偀潁罂罃孆潆蝇塋罌譍鑍穎灐煐瑛桜灜籝噟赢嵤荥鱦鹦楧浧荧蝧啨瑩摬硬癭景桯籯鹰影婴楹譻孾蝿溁撄溋颍暎璎鶑熒纓应鞕颕媖颖禜膡螢鎣碤鶧梬覮鶯媵営嚶莹膺莺藀盁巆嫈盈軈應巊僌柍蛍滎迎賏緓瓔濙濚応營滢郢蓥矨鷪绬廮珱英旲濴鷹韺櫻櫿
hua=劃嬅澅骅砉蒊崋划化螖舙椛枠蘤嘩吪誮花芲搳錵撶樺夻画猾糀譁豁磆驊黊华蕐滑埖哗鋘諙呚话觟姡繣諣摦桦铧鷨釪畫釫槬譮華話婲婳硴畵鏵杹嫿
ha=奤蛤紦蝦哈铪虾鉿
hui=會洃洄瀈缋嘒嬒阓堕蜖褘会圚輝瘣挥逥蔧鐬頮匯餯椲蘳茴鰴儶琿贿噅汇煇孈卉浍婎楎湏幑潓譓噕晖彗豗彙蕙彚恚恛橞荟恢睢穢繢噦晦慧桧靧獩佪繪顪譭詯潰灰灳睳恵絵屶屷虺詼譿溃檅袆媈禈薈暉薉辉銊颒憓檓隓悔芔嚖蚘喙檜撝螝璤殨誨墮澮璯鮰暳讳隳咴瞺徻徽麾毀毁賄廆毇濊泋痐蛔哕蛕囘櫘绘滙翙诙翚回惠烠闠僡烣槥烩蟪囬燬翬寭揮藱諱珲篲诲懳燴迴鏸廻拻廽秽翽
he=爀萂阂焃餄朅紇合礉褐吓阖鸖蠚頜謞渮欱猲訶核訸贺楁煂敆噈鑉癋鉌靍靎靏何齕鹖呙啝鹤詥赫呵荷饸籺魺龁鲄熆嚇熇覈貈貉咊碋和颌垎袔澕喛螛喝閡鶡龢閤纥麧鞨皬粭鶮抲河鶴涸隺咼劾禾姀賀嗃诃郃峆柇盇寉盉蓋盍菏壑惒盒闔篕盖苛釛狢哬嗬翮翯曷燺毼
bie=莂蛂別彆鼈蹩鱉瘪别憋虌柭柲襒徶鳖蟞龞癟
hun=慁圂魂眃焄馄轋掍棍阍昏浑俒蔒棔殙婚惛餛焝尡諢湣荤睧觨诨婫昬睯倱珲鼲睴忶混湷溷葷涽閽渾琿
huo=嚄閄攉礊謋和禍霍沎趏劐喐眓或瀖蠖伙吙掝騞咟耠窢夥鈥蒦货貨邩锪钬嚯耯檴漷获活嚿豁鍃靃韄矆捇濊鑊矐惑雘臛彟彠姡旤曤篧艧剨癨濩火穫灬镬擭秮奯俰湱獲秳秴煷佸祸藿
bin=鬂汃摈斌鑌髌砏臏儐膑频濒賓鬓賔镔椕瀕髕槟邠殡玢鬢缤霦傧滨虨豩髩彬顮擯殯濱檳豳濵瑸璸梹頻份繽宾
shai=諰簁晒攦篩摋筛簛曬籭
zhang=粀蔁嶂礃墇丈璋掌帐瞕障鞝麞樟张弡鄣账餦涨瘬涱暲漲帳漳瘴張脹粻傽騿胀鱆仉兏獐蟑杖仗扙幛嫜慞章幥仧遧賬痮彰鏱長长
hu=焀萀頀簄昈鸌帍鬍縎戏笏礐嘑昒弖鰗怘怙蔛嘝縠鄠匢猢琥弧匫瀫唬餬戯搰蔰戱戲戶頶户戸核謼戽唿錿鹄扈虍乎虎歑浒乕鹕湖虖恗絗鍙瑚衚楛楜祜虝婟幠鵠摢葫乯鱯豰魱鹱煳蝴護轷鍸汻呼垀抇和沍粐芐醐枑互綔芔喖鶘嚛斛螜护鶦媩熩沪鶮冱膴芴岵箶许隺鶻嗀烀嗃糊狐雐泘惚瓠鳠瓡胡寣軤濩囫滬嫭嫮姱鯱槲淲瓳觳槴淴壶曶壷觷滸苸鳸滹壺忽雽俿
xun=紃焄稄訊逊尋爋蘍栒爓訓訙伨鄩攳樳眴洵愻噀荀蕁卂恂鑂坃畃煇蕈杊鱏浔鱘孙噚浚汛遜奞潠詢塤灥荨顨桪孫潯獯驯偱纁徇殉熏嚑璕侚鲟窨循薫训讯咰薰馴醺鶽殾矄燅迅郇勋峋壎臐燖揗埙勛曛巡询珣毥狥壦駨蟫旬濬姰勲勳蟳廵巺寻燻巽迿
beng=繃埄祊堋蚌閍甏嗙镚鞛奟嘣琣絣蹦崩琫逬嵭甭痭甮跰鏰埲綳塴泵菶绷迸伻揼
pei=伂妃衃婄醅旆錇攈霈怌配嶏媐棑帔赔辔俖妚胚沛蓜淠賠轡琣肧佩陪锫阫柭珮毰裴姵裵抷馷呸柸培犻斾浿
nai=乃奈腉耏耐鼐疓氖萘螚釢褦摨嬭柰搱妳佴奶倷迺孻廼錼能渿艿
pen=呠葐湓噴歕濆盆喷翸瓫喯
nan=戁喃揇枏暔遖南畘娚囝柟妠楠囡難赧嫨抩腩莮湳萳煵諵男婻蝻侽难
nao=鐃硇橈詉譊巎摎嫐脑臑夒怓撓堖淖匘瑙碙铙閙挠桡婥腦鬧嶩悩孬碯蟯峱惱猱蛲脳垴呶獶憹闹恼獿
liang=梁鍄谅倆辆凉緉踉魉椋輌辌俍魎量樑諒靓墚掚輛倞両唡啢悢两糧喨莨俩兩輬亮粮良粱裲哴湸駺涼脼蜽晾
song=娀枀送怂颂吅鬆凇棇宋頌濍漎捒揔摗柗菘悚淞訟愡楤梥竦誦崧檧嵩枩忪慫倯愯傱聳诵嵷駷耸餸硹鎹庺讼憽松
chou=愁瞅椆疇搊躊嚋踌讎讐丑丒儔醔皗鮘吜醜怞殠稠綢嬦栦犨掫犫紬檮帱瘳薵醻梼抽矁惆仇籌絒雔菗魗篘遚雠偢婤懤畤俦雦酧盩诪幬酬臭裯牰臰畴詶绸筹杻杽燽跾
xve=踅蒆斈趐谑茓謔袕薛岤膤瀥辥疦嶨澩辪樰瞲怴鸴疶吷鞾血峃壆滈鱈削轌彐鳕桖狘艝燢学敩雪泬噱乴穴靴泶觷學坹鷽
hong=娂鞃溄妅紅訇綋訌閎宏霐澒玒撔宖沗弘紘玜鈜唝嚝霟粠焢红讧閧薨鬨愩洪垬紭纮吰渱厷輷渹谹鴻谼吽羾耾谾銾鸿闀潂闂翃哄巆揈黉嗊篊彋黌呍晎慐鋐竑葒泓葓硔烘仜翝轟魟硡軣浤竤鍧瓨荭汯苰轰浲闳灴鉷屸虹蕻叿
weng=嗡嵡暡翁奣滃齆瞈螉蓊罋聬瓮鶲鎓塕甕蕹攚勜鹟
gua=劀挂褂歄胍冎趏剐絓诖呙掛銛瓜栝寡罣諣卦铦叧騧啩颪罫坬括刮剮桰鴰呱煱颳鸹緺踻咼銽袿詿
gui=嬀鐀簂昋簋椝椢猤茥匦騩蘬匭圭眭匮帰攰匱攱贵鬶朹鬹樻鬼刽刿氿湀筀桂硅硊鑎癐恑归陒鱖襘鱥桧轨祪摫詭瑰晷歸癸佹亀傀宄炅瞆皈劊庋劌撌溎規窐鲑檜龜垝璝螝龟嶡瞡閨庪妫厬禬鮭媯嶲貴瞶趹鞼邽袿巂櫃规廆瓌軌郌軓蓕柜鳜雟蟡诡嫢槣觤珪跪蛫櫰槶櫷闺鳺槻槼姽胿
ji=鸄済計刉吉簊丌簎蘎刏尐踑踖鐖稘記戟瘠鸡戢耤急稩樭耭丮蘮嘰瀱堲鰶稷帺蘻谻稽績鰿虀鱀乁剂穄际鑇偈塈塉穊繋積籍屐蹐湒摖穖鑙剞機蹟癠鹡剤汥艥驥穧乩癪葪繫鱭偮虮屰汲橶繼幾鱾技皀麂撃犄銈誋躋嚌岌肌皍劑檕鲚際檝梞亟撠銡璣躤骥级暨芨暩纪鲫咭隮芰犱庴檵悸躸蒺亼墼亽撽璾曁櫅諅郆集嫉擊惎諔棘给苙裚哜雞僟蓟擠飢勣继雧绩賫廭櫭鳮磯泲賷系髻磼紀霁漃笄蔇漈笈缉脊伋茍伎洎焏紒級朞期挤茤錤唧輯愱攲霵唶机霽圾鬾蕀襀嵆奇嵇襋鵋齌蝍赍济齎譏齏彐彑饑齑筓鍓魕坖楖潗卙轚魝畟荠魢季譤饥魥給敧楫祭即嵴極佶其彶畸蕺卽罽兾畿冀妀极羁枅鮆羇羈瞉覉薊覊鞊膌趌垍掎螏鶏玑辑妓箕継徛殛禝喞趞计讥禨綨覬嶯记薺鶺疾憿箿鞿激淁緁寂寄毄鷄濈槉藉及觊忌鷑嗘诘觙鯚叝緝姞濟几懠旡跡既忣旣槣蟣揤姬觭臮积己韲痵矶鏶迹基击懻跻叽跽鯽
guo=圀椁褁簂馃锅國漍墎喐瘑嘓猓膕馘鈛果餜堝崞輠涡渦蔮掴綶鐹咼帼蜾粿腂濄楇过惈蝈蟈彉淉敋鍋矌彍櫎過摑聒菓慖懖囗幗腘呙埚聝虢槨郭啯囯囶裹囻国
gun=鯀惃緄輥鲧丨蔉辊鮌棍硍衮绲睔謴緷裷蓘磙滚滾袞
tong=綂氃憅銅餇樋同垌蚒鲖侗通庝犝粡朣鮦膧眮瞳炵砼茼峂哃偅捅曈痌晍桐燑峒筒烔衕鉖痛穜铜仝峝獞佟慟统彤童橦硧絧赨筩狪蓪勭僮酮秱統囲嗵浵鉵桶詷恸潼
ping=甁鮃涄鲆簈娉蘋萍憑檘帡輧焩頩馮冯砯庰枰帲蚲箳洴玶甹岼缾塀评幈屏硑乒胓荓評泙屛俜淜聠蛢坪凭竮呯蓱郱平凴艵瓶苹鉼慿軿
qia=髂硈磍殎掐鞐跒擖愘葜峠酠卡帢揢胢拤咭恰抲圶袷匼洽冾
ju=輂欅弆怇椇椈舉匊崌怐椐且锔焗眗踘挙怚琚昛蜛蘜踞耟渠砠伡鴡焣倨锯洰鼰愳鼳簴娵倶挶鐻踽举局婅居鉅艍詎腒桔橘繘鵙聚罝齟虡筥聥屦豦车剧驧屨湨歫蹫乬婮据陱鵴具襷啹驹遽咀龃趄抅躆劇鮈榉檋犋鶋犑莒袓粔鮔貗榘趜钜蒟岠鞠岨蒩鶪鞫掬炬窭邭梮沮閰讵醵窶螶颶侷粷蚷枸躹涺澽疽瞿忂泃懅珇巈壉狊菊諊車雎駏拒駒飓跔姖淗拘狙跙據柜距揟寠拠苣俥凥句烥泦鋦埧惧擧巨毩矩僪巪秬勮俱毱苴駶櫸鋸郹蓻懼跼埾裾
dou=鋀鈄瀆豆竇吋渎枓抖郖餖唗斗瞗逗閗痘酘闘兜唞兠陡浢斣鬥窦鬦乧阧梪蚪鬪鬬毭钭鬭脰荳狵橷侸蔸吺读篼都饾
qie=淁窃椄茄趄郄朅苆切挈慊竊篋疌砌悏契厒且栔穕跙嗛愜鯜笡籡踥鍥匧稧箧蛪惬怯洯猰锲帹聺伽妾癿
mai=邁佅衇脈迈脉埋蕒卖唛霡劢霢賣麥麦嘪荬买勱売薶鷶買霾
tian=餂殄倎舔阗舚甛銛甜栝琠覥天錪鴫掭田璳窴碵搷甸唺沺銽紾悿钿緂佃腆鷆屇黇湉畋胋磌觍鷏闐呑畑睓靔婖忝靝淟賟酟塡铦晪填恬瑱兲奵痶盷添菾
tiao=芀脁誂调龆挑趒朓萔窕鞗銚粜覜條斢庣樤笤嬥鎥鲦岧宨蜩窱朷鰷岹眺調晀啁鯈恌聎祒苕蓚鋚齠条迢祧蓧蓨絩旫铫髫跳糶佻
ka=喀垰卡鉲裃咔咖佧胩咯
qin=沁覃蠄綅媇搇庈笉抋檎骎昑螓锓嶔瀙蚙鈙唚誛嶜吢吣肣钦芩親梫鈫溱亲撳斳琴侵琹耹芹螼鮼欽瘽禽澿嫀雂懃懄坅顉埐寑廑擒兓寖噙嵚矜寝矝鋟珡寢菣勤捦秦菦嗪慬鵭嵰扲靲菳寴忴駸鳹藽衾赾揿
mao=瞀氂茂冃皃耄茅枆茆冇眊貌冐冒覒暓貓愗夘鄚锚犛鶜媢袤堥錨猫鄮昴渵笷贸萺戼芼帽貿峁瑁旄铆蟊懋嵍秏蝐柕酕泖楙鉚毛矛罞軞緢蝥牦髦蓩乮卯髳毷鉾
ke=堁錁缂尅渇悈礊瞌騍颏犐骒娔袔搕樖薖颗愘溘醘愙礚閜稞锞窠客岢砢炣碦頦氪萪嶱課咳鈳渴疴蚵钶趷刻殻匼榼殼窼勀歁牁髁珂磆顆峇衉勊克剋蝌艐嗑嵑科磕翗嵙緙苛硞揢敤恪铪濭可柯牱轲壳呵棵坷軻痾课鉿
tou=亠鋀斢蘣敨黈愉頭媮鍮紏透緰骰埱飳头妵投偷偸婾
man=満墁蔄瞒馒蔓鞔悗鬗鬘瞞颟樠鄤缦娨螨谩漫澫蘰熳縵澷蠻鰻謾饅僈埋鏋獌蟎姏幔襔矕鳗屘镘嫚鏝满慢顢蛮摱慲絻曼槾滿
qiu=芁梂鮂球訄頄訅璆玌紌鰌肍莍鰍逎殏逑唒蘒醔鶖丘龜媝搝龝渞龟丠蠤趥鞦鞧萩蚯犰邱皳銶崷厹朹鰽鼽求鯄俅泅鳅仇赇秋酋秌篍扏穐遒汓觓賕浗糗蟗恘裘鹙囚橚盚釚蝤緧觩煪湫牫毬湬虬湭巯虯巰蓲叴坵蝵恷蛷塸楸釻艽絿
meng=鼆氋萌甍鸏氓蠓莔溕蒙儚猛礞冡夢瞢蜢夣霥朦梦尨庬檬锰鄳錳鄸掹甿霿靀鋂蕄矇艋鯍勐矒蟒橗曚濛饛懜擝懞孟盟癦艨幪顭鯭蝱鹲髳獴懵雺虻黽黾
quan=辁鰁輇圈犈鬈鐉權圏縓銓悛醛劝箞踡騡綣洤椦颧権犬犭弮犮蜷券蠸搼硂权荃烇虇鳈孉泉痊狋筌奍畎闎巏韏峑惓瑔矔婘絟觠诠埢齤灥勧跧全铨駩槫棬恮詮捲葲啳拳顴湶牶牷勸佺绻姾楾
ku=堀郀捁焅俈窋桍跍挎朏圐胐库瘔绔秙楛狜扝絝硞窟廤裤苦庫鮬哭枯褲刳嚳袴酷骷矻喾
la=溂垃柆喇臈菈拉爉腊攋楋翋蝋邋剌瘌瓎鬎磖臘搚藞鑞蠟蜡鞡辢辣啦揦揧砬旯蝲櫴镴擸嚹鯻落
shao=睄艄佋娋稍绍芍捎輎少袑燒旓杓苕柖鞘梢綤莦烧哨召劭弰蕱卲潲筲邵韶萷紹鮹勺焼髾玿
shan=儃栅謆嘇贍訕嬗笘删脠舢鐥搧刪椫缮鄯圸騸挻樿縿扇穇杉饍睒幓鱓煔鱔单汕繕陕灗歚陝剡彡赡衫潬山晱譱潸赸摻剼煽敾閃善閄禅檆閊熌銏钐傓邖澘疝掞芟骟墠墡覢撣嶦禪讪單膳羴炶羶掸掺膻痁擅鯅珊姍埏僐軕姗跚鳝鳣釤狦闪苫蟮磰柵蟺
chuan=歂遄篅荈圌汌瑏钏玔賗喘氚巛舛川膞传舡僢釧鶨舩猭椯串輲傳踳剶暷船椽堾穿
le=仂樂了忇肋餎玏乐扐泐勒鳓簕嘞牞阞砳鰳鱳韷饹叻氻竻艻楽
chuai=揣膗踹膪搋啜欼
li=栃爄砅樆理蠇娌琍栎吏爏刕栗栛瀝鸝蠡蠣逦利蠫砬縭搮娳砺蘺丽戾砾鹂艃詈豊扐剓灕呖鑗癘扚塛鉝癧鱧驪籬瑮婯鱱穲屴剺鱺犁犂璃纅傈骊邌貍邐銐粒躒麗劙纚蒚力犛麜悝粝蒞嚟悡犡鲡鲤沥嚦岦暦悧溧梨檪皪励沴粴沵隶悷隷梸蚸隸棃囄瓅曆囇瓈苈立糎蛎黎裏瓑櫔棙苙峛曞櫟嫠盠蓠蛠裡壢峢離鳢瓥郦黧鳨哩櫪鋫盭竰鋰峲廲糲雳勵狸擽磿猁鬁锂錅攊蜊唎欐漓鴗茘欚笠缡攦蜧謧礪礫攭儮礰鬲唳褵儷脷朸礼蔾靂慄酈镉孋靋李荔睙坜杝睝轢筣轣浬浰荲赲歴孷歷蝷罹轹鵹斄莅历讈厉莉例涖厘鎘綟疠厤枥澧醨疬禮厯喱厲禲醴离巁柂鷅鯉里蟍鯏俐釐凓叓叕珕俚藜秝菞跞痢迣篥俪鏫鯬篱藶蟸觻濿
lo=咯
neng=螚能
ruan=瓀偄媆堧朊撋瑌輭耎阮软壖緛檽碝礝腝軟
cou=腠凑楱輳傶湊辏
lu=椂瀂錄騄輅蘆氇漉栌氌渌蔍攎簏樐爐稑鸕瀘樚踛謢圥蠦鈩甪鐪簬鸬琭戮舮逯録露錴簵簶舻騼鴼娽虂赂轆陆硉穋罏虏彔录蕗蹗籙籚噜虜摝潞穞卢艣卤轤鑥镥鵦睩艪鑪艫六鹭魯顱鵱魲轳坴硵鹵塶塷陸鱸剹橹獹祿鹿醁鲁辂禄颅垆玈鲈炉碌庐璐纑侓箓麓膔嚕辘澛熝趢枦芦嚧螰掳粶璷撸馿鏀賂擄僇菉峍勎瓐矑緑櫓淕鏕髗廘壚臚盝勠磠曥淥鯥盧櫨胪廬路鏴滷泸黸鷺觻擼蓼蓾绿
lv=氀膂稆率榈爈律垏膐焒挔吕缕褛瞜膟梠綠儢膢侣閭氯侶縷褸箻鋁僂呂嵂繂旅捋葎緑虑櫖藘郘櫚卛捛鷜铝屡屢鑢驢祣滤履穭慮勴驴哷慺偻絽濾闾绿
shen=谂蜃蜄瘆谉瀋谌眒堔渖渗眘蔘昚甚弞娠氠訠甡頣脤甧瘮鰰吲申紳搷砷訷伸嬸椹鰺愼慎腎敒幓罙葚神兟扟葠鵢罧魫鉮祳詵婶籶籸呻穼屾侁涁讅沈榊抌薓莘审邥瞫身宷鲹侺妽肾覾什嫀糁参哂糂胂參叄叅珅绅燊曋曑裑鯓諗柛诜糝鋠信蓡糣矤矧審駪黮棯淰深滲鯵峷姺棽
shei=誰
pie=嫳苤氕瞥覕鐅撆撇暼潎丿
chun=橁瑃櫄萅偆槆鰆唇醇犉鶉媋朐鹑蒓純醕漘暙陙鯙芚膞錞鶞蠢滣脣春肫纯賰浱淳蓴輴杶睶萶惷箺湻莼蝽旾椿
chuo=踀鏃擉龊辍孎踔娕娖淖惙繛啜鋜輟餟歠趠鑡婥齪酫磭涰绰戳逴辵辶吷箹拺婼嚽綽哾
nei=馁那内內腇哪脮餒錗鯘氝浽娞氞鮾
ma=獁码閁蚂骂祃庅蟆亇蟇么妈傌鷌嗎鬕孖吗犘嘛玛嘜螞禡駡鰢溤遤摩杩榪瑪馬马睰嫲痲痳蔴罵鎷犸抹菻麻碼媽
pin=榀品矉蘋砏频嫔琕汖礗姘聘蠙拚牝驞娦穦颦貧嬪馪贫嚬玭顰薲拼
lai=箂崃來鶆倈萊攋騋崍猍娕徕琜涞徠疠瀨逨瀬莱庲麳錸誺唻頼梾籁顂赉睐濑赖癘筙賚癞睞籟鯠婡鵣来癩俫襰郲櫴賴棶淶铼藾
nen=嫰恁媆嫩
chui=埀箠顀龡垂腄锤搥炊圌槌椎棰陲倕捶桘錘吹惙菙鎚硾
me=嚰嚒庅么濹嚜麼麽
sou=廀獀傁凁蓃摉鏉馊廋螋鄋瞍蒐捒籔飕嗖摗艘醙叜捜搜擞叟櫢撨藪鎪騪薮溲欶瘶棷擻锼颼嗽嗾颾餿
lan=爁嚂醂榄欄钄缆栏阑斓攔斕暕讕儖欖欗岚爛澜纜躝漤爤爦覧蘫攬蘭谰厱褴璼覽嬾瀾烂籃孄灆壈览啉韊譋闌藍壏孏惏嵐囒懒瓓坔襕燗蓝灠灡懢燣籣襤擥滥拦镧浨婪濫鑭篮兰幱罱顲襴懶燷糷葻揽襽繿
lao=老崂樂窂耂澇撈鐒嶗涝唠銠耢憥朥憦簩粩醪嘮耮鮱劳栳労躼落咾軂恅癆乐轑铑硓荖僗烙络髝勞捞顟嗠絡牢姥潦蟧痨嫪酪狫佬橯珯蛯哰磱浶铹
jiao=礁嘂較餃嘄搅笅訆娇踋儌嬌挍鐎嘐椒嬓樔漖脚校挢簥嘦焦攪茭茮缴捁鵁孂灂癄浇轇晈蕉筊呌噍煍摎敎轎鱎潐譑恔驕教灚穚絞虠獥譥鹪敫湫湬噭繳腳酵摷鉸饺佼敽艽剿敿轿较骄澆劋窌憍斍悎皎纐覐嶕窖覚鲛暞撟嶠斠膠憢嶣龣交侥皦鮫喬璬皭趭醮膲撹徺覺嚼徼憿釂烄觉郊燋賋曒角珓滘蟜燞绞蛟藠狡姣峤跤僥釥勦鷦峧叫矫臫僬蟭鷮矯铰胶
mi=戂羃瞇枈芈麊羋麋鸍侎粎謎鼏熐謐樒脒宓榓覓覔沕猕冖簚醚覛麛蜜谜蔝冞漞攠爢洣蔤銤弥嘧谧冪咪蘪弭袮眯瀰禰渳瞴沵檷宻縻蘼怽蒾醾醿麿櫁幂釄觅密敉孊彌泌藌幎塓濔瓕祕灖濗秘峚糜葞擟靡祢幦淧汨米摵滵迷糸詸獼镾
jian=堅戋鰎谏渐瀐踐堑縑蠒戔鰔尖鐗搛減鰜簡鐧戩栫樫谫戬舰鐱瀳帴稴瀸倹鰹踺瀽堿虃詃蹇籈瑊牋葌橏瑐剑鑑鑒湔湕籛豜繝剣豣鹣健艦剪鑬繭牮鑯艰剱艱鑳鉴幵硷鹸聻鹻鹼溅麉碊劍犍劎劒傔劔暕梘檢鲣肩碱袸墹蒹檻撿检雃鋄糋賎囏监鋑鳒諓囝僣拣監惤賤裥諫僭磵件擶建鋻櫼鳽礀朁缄礆謇儉洊鬋猏锏攕笕礛検餞缣茧蔪謭键餰贱椷礷挸漸笺椾弿彅浅襇襉煎荐睑蕑鵑楗坚譛轞捡筧靬饯腱蕳鍳鵳鍵睷奸絸襺兼歼譼譾简箋見閒間榗澗趝熞侟馢徤薦枧涧玪鎫鞬箭瞯鞯殱殲覵瞷熸覸螹瞼趼鶼冿揀韀见揃菅藆跈韉寋减旔珔緘槛姦翦姧鏩柬俭篯釰俴间揵践臶濺菺釼毽
chua=欻
mo=戂爅万脉茉瀎蘑帓尛眜帞砞谟攠漠模嬤謨昩謩末耱礳嬷縸瘼圽眽嘿眿驀饃橅镆么絈陌獏絔魔饝摩魩摸摹魹靺塻歾歿殁貃庅纆銆莈貈貉貊皌馍瞐冒沒劘貘瞙嚜膜没嚤墨沫莫骳抹袹妺枺麼麽蟆鏌髍蟔默黙寞懡狢糢秣蓦藦磨蛨嫫擵嗼嫼
guai=恠拐枴乖箉怪柺罫夬叏
mu=氁霂踇沐炑娒墓蚞模樢木亩砪缪鞪莫暮暯莯朷縸钼畂姆畆穆繆拇狇母畒艒峔慔幕慕楘幙苜畝畞募牟胟牡毣姥睦牧鉧凩毪仫鉬畮目雮牳坶
guan=躀蒄馆倌樌覌官舘鸛瘝莞閞欟爟冠斡管関窤鰥錧輨館涫貫璭琯贯丱観礶纶綸悹悺掼觀观潅罆鏆淉毌灌癏鳏罐矔闗瓘雚摜矜關卝矝鱞慣鳤盥筦遦惯痯关鹳泴鑵鱹棺祼
zhou=辀紂銂甃调謅椆騆輈嚋喌霌縐冑咒箒輖肘宙粙帚疛侜徟舟碡纣骤粥掫咮妯皱週洲薵伷皺昼鸼炿籀啁鵃胄繇绉詋诌淍酎駎烐籒赒籕胕珘賙晝州鯞驟翢噣婤葤周盩呪矪诪晭睭荮郮駲轴菷譸軸僽
na=貀内秅鈉納郍镎拏呐抐挐南蒘笚娜軜笝妠钠那袦哪雫肭嗱衲纳蒳吶魶乸靹捺搻誽豽拿鎿
null=匁虄甅縇栍闏穒囕旕兙兛哛桛硛唜兝兞夞唟猠兡兣乥鞥嗧椧瓧襨朩瓩烪朰瓰瓱乲瓲迲硳喸兺莻厼巼瓼叾怾
ceng=层嶒竲驓層橧噌曽蹭曾
ne=呐抐呢疒眲訥吶讷哪
ni=堄逆猊縌貎抐疑麑霓儗輗掜馜儞眤怩膩倪隬蚭妮鈮伱暱伲妳抳愵昵鲵檷嬺溺蜺尼氼誽匿薿惄柅铌旎胒屔濔狔婗秜跜懝嫟拟你臡呢鯢淣聣泥睨苨蛪擬觬坭齯屰晲郳孴聻腻籾埿棿
kang=穅粇鱇伉砊閌炕抗扛嫝匟邟糠亢囥鈧钪漮鏮闶康慷槺犺嵻忼躿
huai=怀褢瀤佪壊徊淮坏懐槐櫰褱耲咶懷蘹踝壞蘾
nu=孥傉弩努胬伮砮笯帑駑怒奴搙驽
nv=沑朒衂女衄钕恧籹釹聏
huan=鰀綄還鴅貆萈愌攌瞏萑肒瘓缓焕梙渙讙喚堚喛嬛貛阛圜蒝鬟欢患涣澣唤宦羦鲩逭环環缳澴漶鐶垸洹嚾锾犿懁荁奂獂酄睆郇鯇嵈雈孉烉瑍鵍寏奐擐桓歓峘轘还絙雚換瓛狟歡换豢浣闤煥藧緩驩痪糫镮鹮繯寰鍰豲槵鯶幻懽獾
mei=栂袂鎂媄脄梅鎇眉霉嬍美媒沒莓禖攗殙羙媚枚眛嚜没脢鶥昧玫沬堳挴猸妹媺抺渼鬽徾躾旀镁凂瑂睂鋂篃嵄湄镅魅坆湈穈跊嵋毎韎每寐槑櫗痗燘祙鹛糜腜煝蝞楣黣煤楳黴酶睸塺苺珻浼葿郿
kai=剀开岂嘅輆鍇蒈豈開炌鎎锎塏奒愒勓闓烗暟铠嵦鐦鎧慨揩欬濭凯欯凱垲剴锴愷楷恺颽忾愾闿
deng=嬁澄櫈燈等豋璒瀓邓噔憕鐙僜嶝艠戥隥簦鄧瞪镫蹬灯墱凳竳磴覴登
men=門閅鍆穈璊怋虋們懑瞒钔鞔斖焖悗椚惛菛燜瞞懣玧门扪暪捫们悶汶闷亹
kao=靠丂考烤薧嵪銬鯌铐栲犒鮳鲓拷攷洘尻髛
kan=崁嵁歁惂侃墈刊看嵌砍坎衎顑龕轗偘勘矙冚阚槛龛栞闞戡磡輡堪鬫瞰莰埳凵竷扻檻欿
rou=蹂媃糅瓇葇鰇瑈粈揉肉宍鍒柔鶔韖渘蝚脜煣鞣騥腬輮譳禸厹楺
ang=仰醠昂岇枊昻卬盎肮骯
lang=崀稂螂樃鋃琅勆艆阆蓈廊蜋埌郎嫏斏誏郒锒榔朖朗蒗郞硠蓢朤筤莨浪閬瑯鎯塱哴欴躴啷桹烺駺狼
shang=丄扄商殇樉上晌蔏赏墒愓禓緔贘尙尚鏛鑜鞝觞賞漡伤殤汤恦垧螪謪埫慯湯绱滳裳觴熵傷鬺鋿
qing=漀碃頃掅清庆錆樈圊箐殑暒輕夝檠甠氢謦綪親氫儬鲭綮氰亲殸渹蜻庼倾傾檾罄情寈凊請鑋勍廎擎擏靑青鯖硘苘靘葝剠埥黥櫦啨濪磬郬晴慶请顷淸轻軽棾卿
ou=區鏂怄蕅毆甌鴎歐膒嘔呕藕鷗吘櫙漚腢沤鸥耦欧慪瓯熰藲謳殴讴偶塸区禺吽
pa=筢汃皅舥苩葩啪帊爬钯妑掱扒趴帕怕潖琶杷耙袙
chuang=牀刅怆噇床牎剏摐窓牕闖窗剙创喠瘡幢磢朣橦疮闯刱愴創傸窻
pi=錃鴄朇猈鸊錍砒伓甓笓礔丕礕紕鼙耚鈚吡崥否稫圮蠯阰蜱脴琵怶焷匹鈹霹伾脾屁陂潎癖腗鉟罢啤睥鵧譬魮副坯罴陴罷批噼豼噽豾魾庀悂禆羆枇劈枈疈嚊炋疋榌膍蚍鮍嶏鲏貔銔螕芘妚鎞鞞辟銢隦披被嚭皮岯纰媲疲邳憵肶抷螷澼蚽蚾壀諀旇磇狉苉揊翍铍嫓狓駓擗毗毘秛濞痞淠秠闢埤裨郫髬仳篺僻釽鷿
dui=堆譈兊隊祋兌啍對綐兑敓碓磓鐓垖敚轛鐜憝憞懟队塠瀢敦镦濧頧瀩鴭陮薱譵杸对濻怼痽追対
dun=遁伅礅惇逇坉庉撉燉躉沌鈍驐頓橔炖砘犜钝憞潡囤獤敦吨墩墪墫楯遯踲蹲忳蜳撴碷噸趸盹盾蹾顿
duo=咄挅挆掇嚉隋鬌缍趓隓堕多垛夛垜崜憜綞媠枤喥度鈬墮尮墯椯沰踱躱馱嚲沲躲袳隳刴朵舵朶亸鐸夺剁柁柂軃駄哆陊铎陏敓畓杕桗凙哚敚仛杝剟敠跢痥跥奪敪剫柮惰裰奲毲饳埵跺鵽硾飿
po=尀颇钋溌粕醗頗嘙昢蔢皤岥箥洦嚩蒪搫鄱醱朴破岶砶钷笸猼敀珀繁陂魄婆櫇泊駊翍湐潑鉕釙烞坡奤酦迫哱髲叵廹泺鏺泼濼
zhua=抓爪檛爫簻膼挝髽撾
pu=纀箁圃氆莆炇贌匍檏圑瀑舖舗暜璞鐠堡墣圤溥瞨抪脯蒱谱撲蒲攴暴朴攵樸仆鯆擈菐扑埔僕噗捗穙獛譜曝陠痡葡镤浦柨镨菩諩鋪普濮烳鏷酺铺蹼潽秿
tui=俀退螁蹆蘈聉讉魋忒僓颓橔蜕弚弟墤隤娧推穨褪蹪藬尵蓷頹煺頺侻蛻頽骽駾腿
nie=钀踂涅帇隉蘖踗讘嚙踙掜錜攝颞躡蠥嶭鎳銸圼枿囁聂摄痆鑈峊镊籋菍镍捏囐揑蹑闑囓巕噛乜敜篞陧齧嗫臬啮摰櫱糱嵲臲顳糵聶苶槷鋷鑷捻孼湼孽
tun=臀鲀坉庉噋臋蛌啍呑涒霕黗豘軘芚豚朜吞憞焞囤饨魨飩褪屯忳旽氽暾
tuo=蘀鮀侂咃袉鼉莌鼍鴕鰖託萚咜嶞媠碢砣砤阤妥袥鼧箨騨挩脫讬椭岮沰撱沱脱馱沲馲鮵鸵堶涶庹侻紽唾陀柁陁駄跅乇鉈铊跎鵎狏橐汑詑驒拓杔拕楕拖槖鋖佗托仛籜捝杝柝駝驝駞魠扡酡橢毤飥饦坨驮啴彵嫷毻驼
lei=攂蔂誄讄纇銇肋礌纍樏檑錑垒耒鸓欙涙頛纝蠝嘞儡洡瘣颣礧缧礨頪傫累蘱縲蘲鐳禷羸鼺儽厽蘽塁靁擂瓃灅虆磊矋蕌罍櫐櫑勒诔癗壘嫘鑘淚類藟轠磥壨鱩泪絫镭祱雷鑸酹类畾蕾
nin=拰恁您囜脌
bang=膀旁綁蚄磅梆幇髈鎊蚌傍縍绑镑搒棒棓牓艕稖蛖謗幚榜浜塝捠蒡玤谤鞤硥邦幫邫彭帮蜯挷垹
qi=嘁萁七蘄耆萋丌砌頎騎騏蠐鐑栔气萕栖訖気稘戚倛氣琦踦琪鰭启簯簱娸騹帺稽湆呇湇豈蹊婍籏噐恓汔摖剘呚乞桤器艩陭呮扱晵屺葺桼汽颀炁碁岂璂墄沏岐骐芑蚑隑骑麒亓岓蚔邔碕蚚碛亝芞亟咠麡暣梩芪鲯檱袳肵傶碶粸悽櫀盀棄諆棊滊棋鳍竐竒僛磜軝泣磧棨磩郪諬绮棲蛴盵褀企弃褄漆甈猉缉霋伎崎焏脐鬐愒洓唘礘锜蜝蜞期夡錡紪欫唭愭攲欹欺圻鄿鬿畁祁奇祇祈罊齊魌啐齐契啓啔嵜杞啟荠畦敧歧蕲其起鵸祺慼慽捿鶀玂憇螇鶈斉斊掑玘枝趞禥綥綦疧螧綨憩讫綮喰綺薺妻榿緀旂跂凄藄迄淇迉臍柒淒藒忔鯕旗闙鏚濝緝俟懠揭槭觭釮忯矵埼蟿
niu=狃炄莥孧扭钮紐沑怓鈕靵拗忸杻牛汼牜抝纽妞
zeng=锃譄贈囎憎甑繒璔増鱛綜增赠縡鋥橧鄫缯矰竲磳鬵熷综曽曾罾
zai=抂洅哉載再儎菑仔烖扗畠縡傤在溨酨宰賳睵崽栽渽災载灾甾
qu=鼁欋焌氍朐阒欔鸜耝鴝刞渠爠匤蘧鼩欪鸲戵娶紶蠷鰸伹阹区蠼區浀煀筁驅絇屈灈佉葋鱋衐詓蕖詘祛佢衢坥籧癯驱齲敺蝺鑺魼呿嶇憈趋龋鶌趍岖璖趣躣趨璩斪袪劬粬麮躯麯覰誳岴閴麴螶覷麹厺去覻蚼抾瞿軀忂菃闃蛆駆駈胊诎蛐翑觑取竘蟝臞胠黢苣軥竬淭曲磲翵髷
zan=暂讃攅贊撍喒攒鐕讚昝鐟攢儧簪暫簮咱趱趲禶儹鄼錾寁兂酂噆酇瓉囋糌灒瓒蹔桚瓚賛揝赞饡鵤鏨鏩穳橵拶篸襸偺濽
zao=皁艁躁皂竃璅栆竈簉梍唕棗糟譟造澡唣枣蚤慥燥蹧早醩噪璪遭傮趮煰灶薻藻凿喿鑿
kuang=抂誆纊爌誑眖邝匡儣礦匩纩洭丱岲况眶贶圹貺鄺劻夼邼昿砿況狂硄狅框恇絋迋黋矌哐筐诓絖軖壙鋛鑛卝鵟曠軠軦懬穬懭軭鉱诳旷忹筺矿
kong=倥崆控埪羫椌恐涳錓孔空鞚躻矼箜鵼悾硿
re=熱渃若惹捼热喏
wang=往暀抂徃妄蝄瀇枉王辋迋徍魍网罒罓罔罖忘惘朚望輞蚟亡朢棢尣莣兦蛧尩尪汪尫迬網盳菵誷忹彺旺仼亾
cui=璀瘁脃萃倅脆椊粋崒墔崔琗縗伜缞焠皠趡熣紣疩催膬榱悴膵綷粹隹脺漼竁翆顇襊臎啐凗鏙啛慛嵟翠濢摧磪淬槯忰衰毳
ri=釰驲鈤日衵囸馹氜釼
suan=痠匴笇算祘酸篹狻蒜筭
cuo=酂酇鎈剉睉蹉锉磋蓌夎諎剒縒搓蔖虘错厝莝醝脞莡痤瘥措逪挫蒫矬撮嵯錯嵳瑳遳庴鹺銼鹾
cun=膥邨澊吋刌村皴竴拵忖存寸侟壿籿
jiang=螀夅疅将疆將傋蒋薑礓膙洚講弜匞犟匠蔣醤耩醬殭港缰讲茳弶強强謽漿螿葁韁塂鱂壃浆豇鳉彊降獎畕奖绛姜顜翞江糡櫤勥奨桨糨摪奬繮滰酱槳絳僵嵹畺摾橿
ru=如嚅鄏挐鴑儒蠕肗蒘邚缛侞縟銣帤褥颥渪嬬辱洳媷薷茹醹吺檽溽袽鴽嶿杁桇筎蓐嗕扖曘汝蕠濡蝡入襦擩顬鱬鳰乳女獳铷孺繻
sui=岁邃鐆谇夊隋碎綏随砕芕檖鞖亗縗嬘娞缞倠瀡熣隧隨鐩眭禭璲誶膸澻尿繀遀穂遂髄濉瓍繐髓滖雖嵗穗襚旞睟祟穟睢譢韢埣绥賥燧煫歲歳哸毸繸鏸嗺浽荽虽荾
chong=翀隀舂嘃憃銃充崇崈褈痋涌种重摏沖蹖衝爞緟艟宠忡憧蝩埫珫虫揰冲蟲铳漴寵徸浺茺罿
mie=吀滅衊瀎薎蔑鴓烕覕鑖櫗簚蠛乜眜搣礣咩孭幭灭懱鱴哶篾
suo=所鏁锁睃嫅璅唆嗍摍鎍莎莏琐娑溑琑簑蓑縒簔獕趖鎖些暛傞唢惢索瑣逤嗦羧褨嗩缩桫梭縮挱挲蜶溹乺鎻鮻
sun=蓀槂笋摌損筍搎孙薞损飧簨鎨荪孫榫喰箰飱狲蕵扻猻隼鶽
sa=攃卅鞈摋脎灑钑撒櫒洒鈒飒纚躠隡泧仨萨薩蕯訯颯潵靸馺鏾
long=垄弄垅隆梇栊漋龍攏茏嶐龒龓爖鸗躘咙龙贚蘢朧瀧嚨尨蠪眬蠬儱礱礲霳隴砻笼昽徿窿巃癃巄豅陇靇竉聋瓏珑矓竜滝槞壟壠籠驡哢拢篢硦胧鏧曨鑨篭湰襱櫳泷屸聾
kei=尅剋
se=澀澁譅嗇濇渋飋擌鎍懎濏穑瀒洓薔轖琗栜塞瑟闟穡粣廧涩閪銫啬繬槭雭歮穯铯歰璱色摵瘷拺鏼
min=渂砇碈錉垊怋暋愍崏民閔鴖缗琘琝玟蠠刡笢簢閩憫悯鈱鰵岷冺笽抿皿敃勄姄珉瑉緍敏湏鳘慜忞忟罠苠呡緡湣潣捪敯泯賯鍲闵僶旻痻旼惽闽黽黾盿
sh=砂蠂适栅耆順瀋耍倏倐树栓堔逝頣瀧瀭蠴怷砷怸栻倽恀灀恃灄遈塒術恕硕聖偗灗恦適衫桬硰衰聲顺塽塾遾墅悆袑墒傓邖墠墡梢邥碩墭梳邵炶傷傻炻肾邿烁胂裋僐裑烒胜裞裟食飠烧士棯声磰裳磼壽棽飾惿夀焂儃鄃椉儍愓餙餝脠脤椫愬鄯失儵礵褷椹焺示礻愼焼脽社饍慎腎祏慑奓煔兘煞神兟慡襡奢饣腧腨襩兪襫奭慯楯饰祱祳慴楴煶襹兽煽酾妁榁膄禅榊熌禓視首榝冟熟覢禪榯膳醳憴熵馶榺膻妽覾釃视釈槊燊释始釋姍燒姗駛姝觞觢釤駪槫秫秲觴釶姺姼懾稅騇樉娋稌舌娍戍爍稍舍税舎舐舒舓訕舜樞删娠訠舢樧刪設鈰刷娷訷騸刹樹戺騻爽樿鉂鉃扄艄扇穇鉇手婌扌剎鉎艏鉐橓扟剡鉥試驦剩詩艭鉮剰牲橳詵婶驶剼穼鉽橾檆抌芍銏抒誓折誜芟骟檡骦檨說説劭誰銴势嫀狌竍竔苕竖諗勝諟鋠諡勢狦狧狩竪苫拭狮諰拴狶勺苼拾髾鋿髿猀欆謆欇鬊嬕挕嬗笘匙笙謚猞挩謪錰挱挲欶笶嬸鬺挻孀十歃獅升孇捈卋捎捒单荗識歙歚卛筛捝譝鍟獡獣鍦魦捨魫筮孰歰譱卲筲獸殅讅殇率守授殊厍莎箑掓厔殖鮖莘厙鎙鮛实掞実审室殤厦莦宩鎩讪宲殳莳宷箷掸殸鮹掺殺箾设玿参參叄珄叅珅鯅识鏉珊鯊鯋双収揓鯓叔寔试受诗鏛诜鏣實菨審篩召毮鏯史揲说鯴鯵毹毺菽寿簁谁谂射谉尌谌氏萐少尗鰘尙尚簛琞搠氠琡鰣鰤谥鐥搧簭吮鰰吲水氵搷萷尸氺鰺摂籂摄摅摋屍屎豎呏鱓摔籔鱔汕豕葚鑜呞属葠鑠瑡汤呩鱪屬籭鱰山籶籸瑹葹呻摻屾蒁粆沈钐蒒蒔沙撣蒣鲥鲨沭咰貰蒴咶璹貹鲹鲺糁哂糂铄擅铈蓍泏賒峕賖峙糝鳝賞蓡糣鳣哨泩铩糬鳲峷泷賸泽鳾攄贍蔎蔏紓贖紗蔘贘甚攝生甡甥唦攦甧甩洬蔬售唰蔱申紳贳收甸紹崻唼崼絁蕂商浉絉嵊敊赊赎赏啑敒絟赡鵢蕣畤啥赦鵨啫畬畭数蕱畲嵵數赸敾鵿綀涁閂閃善閄涉閊疋疎疏鶐薓閖涗斘涚疝喢綤薥嶦綬涭單涮薯閯鶳閷涻施痁嗄闍淑痑旓緔跚嗜鷞痧痩闩闪淰緰深时藷旹跾市丄縄帅瘆嘇昇阇师踈渉上渑縔世渖丗渗縗嘘鸘昚鸤帥瘦帨阩師瘮是昰帹渻嘼縿時繉晌陎晒噓幓繕陕乗乘癙湜陝陞晟晠湤书湦乨繩虪噬乭湯晱虱鹴虵乷陹繺湿蚀隃亊事暏暑麝溡身溮纱庶庻溼纾什绅蛇廈曋绍黍曑仕軕軗曙雙盛滠蛥曬黮绱滲滳绳绶書曻軾蜀省眂蜃蜄輋眎輎霎式弑弒眒朔霔眘眚霜弞缞鼠漡眡鼡圣伤鼪鼫鼭朮缮术弰朱漱眴伸圸輸漺似弽杀潄睄杉佋睒杓蝕睗佘罙束彡睡罧蝨潬潲署杸潸潻轼使侁侍澍输澘鞘瞚鞝澠枡枢澤瞤徥垧垨澨螪瞫螫瞬羴羶侸侺辻枾蟀濈埏忕濕柖濖埘韘柛翜俞矟信矢翣矤矧埫忬蟮忯述石柵埶韶柹蟺柿
ken=珢龂啃褃豤垦懇貇龈裉硍肎掯肯恳錹肻墾
si=鐁瀃騃缌洍耛耜丝思洠愢蜤笥騦儩娰嘶鈶锶鸶鼶伺鈻似佀祀楒虒兕恖汜噝孠杫蕬牭鉰偲絲饲罳鍶驷死蕼傂肂螄貄肆銉澌撕亖禗覗涘咝纟禠価媤梩禩厮斯銯枱厶颸榹泀私磃燍姒飔蟖鋖泗凘四廝俟食駟竢嗣鯣泤飤鷥緦俬釲巳蛳蟴飴柶司糸糹寺飼
pou=箁哣犃婄咅捊掊裒棓抔剖抙垺娝
lian=戀蠊鰊琏鬑帘嬚堜怜蘝蘞漣連錬瀮鐮萰謰鰱匲瀲匳褳稴脸蔹縺鄻簾奁湅煉鍊恋潋噒瑓联摙敛歛楝襝籢蹥籨聨奩慩聫聮聯镰斂劆璉螊鎌憐熑殓溓薕覝纞涟薟媡鲢殮澰莲檶莶醶亷羷炼梿臁濂练僆鏈廉臉槏磏濓连裢櫣裣槤燫蓮練翴嗹嫾链
tuan=疃鏄湍貒鷒煓圕彖褖團漙抟团団揣墥湪槫猯糰慱檲摶剸鷻塼畽篿
miu=繆缪謬谬
liao=憀撂了膋窌钌爎鐐爒炓疗料璙嶚嶛樛簝鄝尞尥尦撩缪膫憭瞭缭窷暸嘹漻辽療竂豂飂繆飉聊摎燎髎橑藔釕廖蹘僚繚蟟獠曢镣寥潦蟧鹩屪廫寮鷯敹嵺蓼遼嫽蹽镽賿
peng=芃纄鬅梈匉憉堋朋錋澎皏莑搒鬔蘕椖倗閛稝熢輣樥怦亨抨漨膨椪踫嘭騯傰漰砰碰袶挷弸掽捀駍淎鹏硑摓胓泙棚蟚蟛塜淜鑝磞篣絣捧蓬鵬彭痭軯槰恲塳篷韸烹苹剻硼竼韼髼
su=梀傃肃肅膆蘇玊簌蔌樎殐涑蘓樕骕謖餗夙趚璛粛憟粟速素榡稡谡稣窣縤莤甦缩愫愬洬縮溯圱訴溸宿碿鯂嗉诉鋉嫊囌穌驌苏塐鱐塑鹔俗藗橚潚蹜泝珟遡埣潥酥觫鷫遬櫯僳棴摵
yao=耀舀鴁樂倄約吆餆匋眑騕搖餚訞謠謡鴢谣尧瘧蘨鰩夭尭怮愮堯猺爻鼼崾筄祅楆摇繇么恌詏乐遙鱙艞鹞獟偠瑤顤遥齩药葯腰杳瑶婹幺轺葽穾摿靿殀邀要隃窅纅岆窈宎熎袎邎皐鎐窑讑喓溔窔窕妖枖垚暚榚銚傜覞疟嶢榣嶤侥钥约咬薬徭抭窯窰媱肴箹徺颻撽殽嗂鷂烄闄矅鳐烑蓔狕鷕飖磘姚曜峣僥藥滧珧铫苭仸揺軺柼燿
yan=言訁琂阉鰋阎騐萒爓験研昖砚谚严娫戭娮樮訮縯堰渰琰谳騴渷簷偃遃扊衍灎晏硏顏偐豓灔豔顔驗噞驠剡豣虤剦灧塩灩顩橪牪湮硯艳乵艶艷恹晻硽詽鹽抁隁沇嚈验溎炎炏檐隒墕颜碞麣嚥暥岩芫嚴梴窴咽躽傿檿沿雁軅铅囐盐郔曕壛滟烟黡嫣曣黤壧櫩棪鳫黫黬胭黭曮黰鳱延黶裺諺烻郾狿唁蔅弇鴈焉嬊贋唌餍猏嬐焑猒蜒演焔欕甗褗贗愝洝鄢崦嬮焰焱鬳鴳鼴夵漹礹鼹椻儼椼眼匽嬿酀嵃奄歅魇楌腌孍嵒嵓酓兖兗蝘魘煙饜赝齞彥敥彦罨啱齴筵酽厃醃閆厌讌妍覎龑嶖熖綖殗莚掞讞妟讠鶠厣喦掩羬厭喭厳厴宴醶殷閹閻醼閼觃鷃燄揅釅淊巌埏懕燕巖巗巘臙巚珚揜俨懨闫鷰姲篶姸菸淹觾
shuan=閂栓拴腨闩槫涮絟
ta=躂嚃它鞈崉鎉粏踏鎑沓錔墖阘榙鮙溚鞜傝挞褟禢躢侤搨鰨漯鞳嚺撻榻溻誻涾澾趿祂鉈铊蹋塌濌鳎嗒闒拓塔他遝闟牠遢闥狧闧獭譶她蹹獺闼橽毾
shuai=蟀衰摔帅帥率縗甩卛缞
zhuo=斀茁劅墌椓蠗禚趠窡琢窧炪斫倬斮撯焯鐯妰斱斲梲鐲犳圴缴丵斵謶琸娺涿蠿着棁濁諁灂啄啅擆捉聉浊汋燋藋桌酌諑卓捔蓔叕槕淖籗著拙穛鋜浞鷟櫡剢擢噣篧晫鵫罬濯镯穱籱棳繳彴烵棹硺灼诼
te=忑鋱忒犆脦蟘特慝铽
ti=鬀鬄褅褆缇稊朑锑謕逖倜弟騠踢眣渧挮逷崹笹戻漽剃奃蹄瑅遆鹈屉籊桋題偍蹏啑荑歒体剔鍗蕛屜鵜屟罤啼睼媂綈悌醍嚏悐嚔禔涕厗鶗题薙鶙媞殢徥掦趧碮梯趯躰徲禵骵鮷銻鳀嗁磃軆鷈鷉瓋提苐體惕惖棣鷤揥绨髰俶珶鯷緹裼惿擿替
zhui=甀缀贅騅鑆膇礈諈醊隊縋笍椎腏錐缒骓赘墜沝奞坠揣錣锥惴綴娷畷隹鵻追硾
zhun=窀衠諄准谆綧圫肫啍迍屯訰宒忳淳稕凖準埻旽
mang=笀吂蘉蠎娏汒芒蟒氓铓厖蛖杗忙邙朚浝痝哤牤硥杧尨鋩茫庬漭硭釯盲盳狵駹牻茻莽壾恾莾
tu=嶀突涂趃悇宊唋涋梌稌堍钍瘏吐徒途圖圗堗土馟鶟圡檡怢蒤庩鈯莵鼵墿禿鋀凃秃捈鷋迌鵌兎鍎兔摕葖塗啚鵚廜痜嵞菟屠筡汢湥揬腯図潳酴鋵鵵鷵釷凸捸峹瑹荼駼图跿
lia=倆俩
rui=蘂蘃兊蕊蕋蚋兌緌笍抐锐兑枘瑞繠叡壡惢橤甤蕤汭鋭芮銳桵鏸蜹苼睿
juan=悁羂讂鄄焆圈錈梋餋圏涓朘鞙娟帣倦椦脧蔨锩鐫弮嶲蠲縳劵眷鎸隽巂闂淃腃鹃奆臇桊睊雋勌镌埍奍捐裐鋑惓鋗婘呟睠姢绢菤罥獧勬棬飬絭捲卷狷瓹絹巻慻
lie=爄爉洌猎躐挒趔列挘鬛猟綟脟儠茢劣犣鬣鮤劦咧颲栵鴷冽劽巁裂烈埒埓浖聗棙忚蛚毟巤燤獦捩煭烮鱲姴獵哷擸迾
run=閠闰潤瞤润膶橍閏
ruo=鄀渃若爇楉焫偌箬鰯弱叒嵶鶸鰙篛蒻婼挼捼
lin=檁亃疄碄崊悋躏甐麐箖霖林璘嶙躙辚撛焛吝綝澟麟隣粦膦冧檩躪鄰琳临斴瞵閵瀶厸蔺邻粼暽阾赁賃啉橉淋懍拎驎惏燐懔轔繗鱗凛癛凜獜癝鳞恡壣轥臨廩廪僯痳遴磷翷蹸藺菻鏻晽潾
hai=餀郂還骇咍妎嗐还饚嚡醢亥氦嗨孩駭絯塰猲胲咳害駴海拸烸骸酼
zhong=伀夂炂瘇妐媑斔妕众鐘蜙蚛钟喠蔠鈡冢刣蚣螤鴤鼨中種舯尰踵徸堹锺茽螽眾肿銿終煄偅盅狆衆泈终柊祌种重幒筗塚穜緟忠諥籦忪腫歱蹱仲衳衶汷衷彸鍾
han=琀猂唅圅丆頇焊蔊笒焓瀚輚甝崡娢漢含蜬蜭爳椷頷攼谽鼾譀豃佄顄嵅睅汉捍罕晗汗晘歛浛扞酣筨浫兯汵虷顸屽魽厂涆厈閈喊悍澏梒螒皔颔撖邗莟馠肣憨熯邯馯銲犴暵涵蚶傼撼垾憾鶾鋎寒忓韓雗闞仠菡鋡嫨韩釬闬旰翰旱鳱哻駻函凾蛿
feng=封蜂覂溄夆瘋锋鴌犎炐莑檒琒綘砜缝渢熢逢沣妦猦沨漨焨風唪枫縫蠭馮冯疯丰蘴崶鄷麷堸碸霻堼讽鎽艂灃埄酆煈篈奉靊飌风豐偑葑鋒摓楓湗赗鏠凤凨凬凮峯鳯峰浲鳳賵寷諷俸仹桻僼烽盽
hao=椃薃薅嚆貉昊皋嚎悎傐皓澔蠔耗鄗皜蚝鰝皞暠茠皡颢暤皥昦薧儫鎬暭侴嘷蒿藃獆籇滈獋曍恏淏灏秏镐噑竓獔壕聕諕乚毜滜灝郝號哠濠嗥顥晧浩豪毫号譹呺好
liu=羀栁疁鐂劉琉碌窌锍麍瀏鎏馏澑刘熘溜骝嚠鰡璢瘤霤蒥鎦熮騮榴鬸媹綹鶹漻嬼餾斿飀流磂飂畄癅蓅飅廇旈蟉橊珋摎浏翏镏鏐驑旒蹓裗飗留鷚遛桞磟瑠镠駠鹠雡嵧鹨硫瑬六橮塯懰藰畱柳駵罶鋶桺绺
bian=弁甂抃窆変邉褊變邊覍缏鞕编鴘炞閞辡玣鶣碥徧辧稨辨辩昪辫贬砭鞭辮箯辯猵覵貶萹边疺辺匾笾便扁糄苄峅釆藊鳊遍牑艑籓变揙蝙諚卞編籩忭獱臱汳汴緶煸惼鍽鯾鯿
biao=墂爂麃贆标蔈骉猋瀌膔膘標熛骠謤儦檦颩瘭颮錶颷褾脿僄飆飇飈婊飊嫑飑杓鳔臕幖镖諘飙飚髟鏢鑣磦藨表彪驫灬滮穮裱淲镳俵篻摽
nang=嚢灢饢擃曩齉乪囊攮蠰搑涳囔馕憹欜瀼儾饟
zei=鱡鰂鲗蠈賊贼戝
zen=譖撍怎谮
qiang=蔃疆嶈椌羌墏猐漒謒薔戕锖戗熗羗鎗墙嬙炝羟蘠抢檣蜣羥戧斨枪羫溬鶬樯玱唴锵搶強蔷强墻羻襁牄跄嗆牆獇繈彊啌蹌槍腔鏘呛蹡艢摤繦廧摪镪篬嫱瑲嗴鏹矼
cang=滄倉獊欌苍藏仓凔傖艙嵢螥伧沧臧鸧匨篬鶬玱舱瑲賶鑶濸仺蒼
wa=娃膃鼃哇韈聉窊徍韎窐咓帓挖畖嗗啘呙砙蛙溛袜婠嗢佤韤漥瓦媧攨窪襪唲娲屲搲穵邷劸瓸凹咼洼腽瓾
qun=裠逡羣群踆麇夋帬宭峮歏囷箘裙
gai=概瓂郂匃匄荄侅賅赅溉忋蓋賌丐峐晐漑隑垓陔盖钙杚姟絠摡畡乢葢鈣戤芥该豥槩槪絯該祴改
jiong=冂泂扃澃扄銄炅絅逈顈駉冋颎冏蘏僒蘔綗窘煚埛煛燛迥臦囧褧臩駫炯侰坰烱熲浻
shou=夀膄守授鏉敊手扌収艏首受獣瘦垨狩痩綬涭售收绶獸嘼兽壽寿
gao=稁锆皋膏皐羔羙鼛搞禞縞缟誥鎬夰檺餻稾吿稿槀槁藁勂告獋鷎镐菒槔糕高篙髙櫜郜韟睪祮臯鋯橰祰诰鷱杲藳筶槹峼睾
gan=咁稈澉芉檊贑粓玕趕甘贛倝肝感榦漧骭皯尲疳簳尴玵尶尷澸紺攼擀绀迀佄橄杆秆詌凎酐魐柑忓泔仠鳡敢篢赣鱤淦衦灨坩旰盰鳱凲干汵赶苷矸筸幹乾桿竿
nou=鎒獳槈耨搙羺檽鐞
ting=庁梃厅霆颋庍綎涏邒耓蜓鞓誔娗厛莛渟脡圢听亭庭閮鼮侱頲榳侹挺町甼汀烃艇嵉忊鋌濎蝏停楟聤铤諪桯廰廳筳烴聴烶葶婷廷聼珽聽
wo=枂沃瞃媉龌龏我踒喔蜗挝窝肟斡涡渥焥渦猧馧唩窩倭涴莴萵薶涹咼撾瓁楃幄濄婐婑臒偓呙腛握濣臥卧硪捰仴齷蝸緺捾
dang=砀儅瞊礑愓欓檔宕璗簜讜谠挡澢趤攩璫碭蘯垱圵崵氹簹鐺逿裆壋擋偒潒当灙党铛筜襠艡荡譡嵣档闣黨蕩盪菪珰當蟷婸噹凼雼瓽
wu=蘁怃蜈戊伍焐娒甒唔鄔洖騖弙霚儛逜渞舞鰞無阢茣堥霧娪圬娬鴮鼯吳吴倵吾洿鼿兀摀鹀齀捂乄敄杅橆杇午呉鹉屋乌杌嵍歍啎鵐潕譕汙汚陚呜扜鹜扝坞污鵡塢扤晤奦武瑦祦嵨物蕪剭浯靰恶婺卼屼牾莁熃粅誈岉躌窏螐庑璑熓五碔沕隖骛芜玝悞悟亡务鎢誣誤梧钨妩溩鶩邬侮悮憮墲瞴膴芴趶窹於箼鯃鋈俉毋烏迕鋘務鋙嗚郚无廡惡鷡忢寤忤痦僫巫釫诬柮误蟱仵嫵珷珸矹雺铻雾勿峿旿
wai=顡崴瀤竵外呙歪咼喎
qve=雀崅埆搉鹊汋闋碏礐炔傕闕阕蚗塙阙蒛硞趞敠慤棤墧愨燩敪悫礭确鵲却皵榷琷瘸確缺卻碻缼
wan=椀笂贃綄芄万倇紈完唍薍贎岏抏輐頑刓琓蔓輓掔脕皖萖蚖夗碗夘脘梚宛莞踠箢瞣貦妧纨玩綩澫鎫琬莬萬弯綰涴帵丸挽錽蜿菀蟃鋄塆婉惋惌毌盌豌卍汍彎卐鋔睕腕捖晚剜婠灣杤捥晥埦忨晩壪潫翫杬烷畹鋺絻晼顽槾湾绾
xian=娊嘕瀗氙搚蘚尟搟尠縣娴稴舷娹显癇鹇繊橌硍癎豏限衔顕衘晛陥灦鑦险塪蹮顯幰婱屳陷鹹橺湺険摻鱻籼咁撊纎撏銑溓纖岘麙躚銛銜鲜咞誢纤險蚬粯麲咸誸暹銽线蚿僊苋嫌烍壏軐胘仙仚狝蛝賢铣铦鋧僩糮苮哯廯僲僴峴諴櫶盷嫺嫻猃崄蜆攇甉唌県錎嬐缐贒攕洗餡贤礥弦挦欦锨伭献霰輱鼸褼鍁絃孅筅祆先鍌睍佡彡啣譣絤獫獮酰襳杴腺獻赻奾掀涀玁綅馅見涎醎閑禒閒澖綖薟羡馦莧羨宪憪綫羬嶮枮鮮瞯现鶱憲箲妶莶醶垷憸玹掺冼县见韅秈槏藓臔藖珗線嗛懢跣臤毨痫姭韯韱闲埳鷳鷴燹跹姺忺鷼臽現鏾
xiao=销踃霄焇猇嘋逍小謏嘐笑簘鴞瀟校崤訤萧嘨洨蠨簫鸮嘯嘵鴵睄彇潇效虈魈削歊婋驍晓虓恔歗穘孝硝獟獢硣詨敩蕭灱筱灲啸呺筿暁骁薂綃斅斆熇消涍肖窙傚皛梟誟憢皢嚣莦庨撨箫枭膮宯咲宵枵誵颵銷効骹嚻殽熽侾箾囂蟂嗃藃淆髇曉毊烋鷍俏蟏髐哓痚翛痟篠绡姣郩哮蟰揱俲蛸櫹
xi=稀鸂舃舄鐊琋阋希戏渓鰓昔爔栖縘瘜鈢氥稧樨怬娭席戯縰戱騱戲蠵吸怸嘻鰼騽舾谿橀豀屃恄葈蹊衋噏汐硒屓恓屖鱚蹝晞习摡扢屣繥豨鉨驨虩鉩繫呬屭息豯晰扱橲晳鑴扸桸穸葸牺犀檄悉墍碏銑钑傒誒犔悕貕皙隙纚邜粞隟犠蒠咥犧躧溪咭袭隰嚱媳蒵隵窸肸肹璽暿惁飁鳃郄细蓆滊郋囍磎壐瓕僖黖郗鳛惜雟铣绤郤曦糦雭烯蓰諰狶磶盻系裼焁礂嬆漇焈嬉鄎唏餏謑洒夕洗漝椞焟锡蜥鬩欪錫霫焬欯細謵欷鼷匸椺霼餼唽愾慀酅譆腊卌睎饎煕歖鵗歙奚潝潟嵠浠獡卥赥赩饩杫兮蕮襲饻西厀熂薂莃熄螅徆螇趇熈禊綌嶍析憘趘徙憙澙熙羛喜膝覡覤瞦禧閪徯醯嶲枲羲鎴熹喺熺玺熻榽係巂淅緆巇蟋觋釐鯑習翕矖翖俙忚凞闟槢蟢忥菥燨鏭釳诶釸觹矽觽忾觿
zha=劄栅霅鲊咋喋怍厏吒挓鮓閘箚樝鲝砟溠醡渣咤喥紥榨眨耫札紮抯宱蚱喳甴皶炸鮺皻蚻搾楂拃痄齄譇齇诈軋乍扎諎牐詐奓譗鍘柞煠铡摣柤查偧轧觰苲剳哳潳飵揸闸灹査
zhe=讁辄者喆厇蜇悊讋粍輒砓蔗锗折輙辙這樜嚞搩袩谪螫謫馲褶踷銸謺鮿着蟄蟅乇轍棏埑聑鷓杔磔著柘浙这淛詟啠晢晣鹧嫬赭遮蛰哲虴襵籷扸慹摺矺鍺嗻乽歽
chang=倀厂怅氅萇阊昌嚐膓猖嘗倘椙玚鼚徜尝甞償肠锠倡暢伥琩錩誯鬯厰唱鲳場悵昶閶常场焻娼鲿畅淌苌兏淐瑒韔菖僘闛惝敞廠嫦仧鯧鱨仩裮塲裳長腸镸鋹瑺瓺畼偿长
miao=瞄玅繆眇缈邈鹋媌篎描藐秒鶓竗苗妙庙廟緢杪缪仯劰緲喵厸嫹渺淼庿
yang=炀攁瀁殃鞅咉徉鸉羊養洋瘍怏眏羏鰑愓禓羕钖暘玚昜氜傟垟岟疡礢樣阦鴦氧央鸯抰輰氱阳炴崵劷样霷崸鴹颺眻紻漾慃蝆詇鍈楊烊柍姎飏佒瑒痒様蛘恙揚鍚駚勜珜鉠癢胦详楧秧杨懩卬扬煬飬敭軮佯仰坱泱雵婸旸諹养陽
mian=宀眄缅芇丏愐渑媔沔冕喕澠眠娩麪麫莬檰嬵麵鮸麺綿婂葂汅糆矈勉棉矊櫋睌免湎矏牑蝒勔緜面杣靣靦緬偭臱绵絻腼黽黾
zhi=栀倁瀄瘈栉帋砋氏搘帙稙稚帜戠娡値訨踬騭踯阯吱搱樴蘵制縶鸷栺稺騺值聀汁驇恉穉晊之职桎豑豒織摕鑕聜幟陟蹠汥汦执摨偫剬摭呮摯職豸衹扺智扻衼乿傂墆犆墌誌銍璏躑窒躓梔蚔劕芖骘炙沚芝袟袠庢肢庤劧抧咫貭隲銴芷纸治隻梽軄郅瓆织雉廌櫍滍胑拓鋕峙铚櫛泜胝滞瓡郦質蛭滯擲擳直鳷軹黹製狾擿夂嬂脂挃贄鼅指輊茋植漐洔猘蜘紙鴙挚椥锧儨质礩紩支眰鴲洷崻贽址坁祇祉潌祑楖捗祗彘止畤坧襧潪杫筫祬歭卮置酯轵絷慹絺轾垁禃侄憄徏疐厔禔綕殖徝枝覟膣斦鶨熫榰膱螲枳徴徵馶妷掷疷疻馽趾识秇翐痓秓淔痔秖跖志觗寘旘蟙鷙釞藢柣痣迣駤懥知俧旨秩凪只姪懫菭忮槯觯鯯跱秲至埴致巵觶執秷臷臸緻淽
xu=需吁朂嬃縃須砉頊戌訏朐休眗嘘鬚谞鄦欨圩栩昫洫欰稰許怴伵漵稸訹欻嘼譃魆晇楈慉驉潊敍湏鑐湑蝑浒噓恓聓歔魖虗酗敘歘虚虛畜獝聟詡恤偦煦蕦絮鱮呴卹须顼婿汿沀瞁溆綇殈暊銊續序侐喐徐禑醑冔続掝疞墟喣蒣芧邪媭妶许蚼垿滀姁蓄烅俆藇裇糈賉惐槒緒勖緖勗叙藚珝諝矞揟蛡淢盢胥盨诩绪珬旭续緰盱蓲旴滸燸壻烼蓿諿
jia=嘉唊鴐瘕戛戞耞挟脥頬猰頰甲猳笳椵鴶夹稼伽夾挾贾圿鉀浃假鵊幏镓荚恝乫鉫葭豭佳扴腵浹婽驾袈颉宊颊犌徍榎貑斚麚梜斝檟加傢榢莢徦岬鎵家架枷袷抸玾钾嫁拁痂泇珈賈埉裌跏郏鋏駕擖铗糘叚槚胛郟毠忦迦拮蛱价價蛺哿
zhu=鸀笁瘃鼄蠋尌逐簗欘洙渚褚笜眝爥樦瀦蠩株猪伫砫逫朮贮术嘱朱茱舳紵丶紸鴸主註帾蠾茿嵀鱁硃鑄佇孎住蕏煑筑絑鉒著罜祝詝属灟橥祩蝫屬豬煮筯敱潴驻乼杼陼坾斀宁钃誅躅麆莇麈窋澍侏宔銖劚羜炢鮢芧助瞩劯貯疰馵殶炷墸斸箸纻袾邾拀蛀拄築苎濐駐囑跓矚竚烛蛛诛燝槠珠櫡铢翥跦櫧苧注磩櫫篫蓫迬燭曯駯柱鋳飳壴篴軴柷藸諸诸铸竹竺鯺嗻秼
jie=洁椄昅礍砎尐蜐訐戒紒踕蠘蠞借頡倢吤耤刦堦刧崨搩截稭丯洯褯謯唶阶堺脻刼蠽琾桀屆偈届界畍瑎楐結啑孑嵑桔潔蝔婕街絜桝湝扢杢鉣癤嵥卩卪魪睫楬幯煯杰詰衱楶捷楷衸她鍻偼镼节鞂鎅皆喈悈颉岊鞊嚌疌趌妎媎庎階傑鲒袓岕疖犗媘鮚鶛檞玠誡鶡徣碣榤接疥芥讦蚧劫媫莭羯嶰嶱誱骱掲家掶袷斺袺嶻劼喼巀節嫅藉介痎姐滐擑毑结裓诘哜嗟蛣解狤觧菨诫揭竭拮擮跲擳蓵蛶价飷秸價迼
ya=覀瘂漄娅岈鴉厊琊压疋庌笌椏稏錏堐厑砑枒厓圔崕吖唖崖掗庘亚猚鐚亜劜挜蚜訝亞圠玡伢碣鸦圧疨鴨氩邪丫窫氬垭鸭涯猰冴讶椻押犽芽呀拁雅軋磍聐哑壓迓铔痖齖牙衙睚瓛潝啞揠桠埡蕥轧婭孲姶鵶俹襾釾齾
jing=踁猄儆稉茎逕頚脛倞瀞弪刭阱鼱弳頸丼剄浄荆腈荊経獍葏坓靓坕靖坙婙聙静靚驚婛睛鵛幜镜靜兢警婧汫敬汬景桱晶橸穽鶁境径璄鶄涇粇颈澋妌殌箐宑徑殑經井莖麖璟麠綡劤璥誩京憬亰劲粳梷鲸傹暻憼肼精净勁菁凈痉惊旌旍擏经俓曔秔痙竞鋞竟巠鏡竧淨鯨竫胫迳競竸蟼泾
nong=欁儂檂濃弄齈挊癑浓脓襛农哝鬞穠噥譨侬禯農醲辳挵燶繷蕽秾膿
cong=憁璁碂樅匆欉漎茐従徔徖漗騘丛瞛熜爜錝從枞愡骢悤蔥謥焧樬琮悰暰怱誴樷潀苁藂婃驄棇灇潈蟌从慒鏓淙聡叢楤聦鏦潨賨忩賩囪聪孮蓯鍯聰囱繱葱篵瑽
ye=謁頁洂射焆鸈礏谒吔爗业夜漜嘢餣堨蠮椰鄴耶爷鐷爺倻饁葉歋腋噎捓晔瑘捙驜也煠靥靨楪業潱鍱页鵺鎁馌暍璍鎑掖殗喝皣亪嶪邪嶫窫亱瞱液澲抴冶墷瞸邺枼咽枽燁壄曄曅野擖曗铘擛瓛埜鋣緤擨烨擪峫擫揲曳曵叶揶僷痷拽釾
hei=黑黒潶嗨嘿
jin=堇縉漌琎嬐贐伒笒儘缙砛紟搢津錦锦嬧紧谨唫進謹堻琻尽赆晉饉晋筋歏浕荕婜襟煡噤瑨荩慬祲靳鹶浸卺齽瑾衿禁枃钅嚍溍墐馑妗榗璡殣劤斤厪侭劲覲璶馸勁仅僅濅黅今緊惍藎仐埐觐廑近金珒釒觔寖壗凚进濜矜矝盡嫤菫烬賮菳蓳僸臸巹竻燼巾槿釿
yi=簃射怈頉谊萓栘逘倚吚萟怡頤頥栧耴瀷逸栺尾怿鐿顊桋籎呓遗顗豙豛恞衣衤衪呭偯豷呹屹遺瑿沂肄钇炈肊撎颐邑悒貖悘袘袣貤悥咦沶貽咿墿峄泄泆峓裔裛食鳦棭胰壱铱飴瓵壹蓺郼裿儀贀夁億椅唈意礒鄓儗洟洢椬焬攲焲夷椸褹崺攺鴺贻浂祎酏饐镒奕煕敡浥敧畩異镱浳饴敼襼兿斁鶂鶃膉鶍榏薏疑禕疙冝熠熤嶧熪疫醫嶬醳憶妷嶷醷熼鷁駅臆秇跇鷊嗌懌痍旑釔旖鷖藙燚懝藝跠燡鷧姨痬燱已釴釶巸槸觺移鷾懿一鸃刈縊渏易瘗鈘蘙瘞帟帠鈠舣阣稦瘱訲昳訳乁乂繄扅幆扆义虉乊詍詒穓癔艗乙湙乚乛驛鹝扡鹢詣艤鹥噫鉯繶晹繹艺艾驿蚁誃亄芅暆檍媐抑劓庡溢檥銥亦劮骮檹誼亿隿曀苅蛇囈益狋曎绎狏黓嫕廙勚嫛蛜黟仡苡蛡苢以蛦勩竩仪黳拸軼蛾异嬄伇匇弈伊弋弌嬑笖猗眙圛匜嬟缢輢欥漪弬霬欭圯蜴挹医謻伿佁坄獈荑杙轙佚彛彜彝杝歝彞潩譩睪齮譯議彵轶齸役佾侇讉枍宐殔螔瞖螘羛讛宜掜依羠螠宧鮧鮨義殪议鎰玴箷辷殹澺枻垼羿柂毅忆珆迆毉翊俋翌译篒诒忔鏔叕揖矣诣鯣迤寱迱寲翳埶埸蟻迻翼
hen=狠痕佷噷很恨詪拫鞎哏
fan=范帆鐇訉樊嬎嬏钒蠜璠薠鐢憣舤匥墦舧蘩販贩瀪礬犯膰笲羳梵笵輽氾瀿犿颿繁噃蕃範畈柉杋反橎汎襎婏緐籓軓轓燔返払盕鱕旙繙拚忛旛泛飜凡幡凢凣棥烦畨煩藩釩番勫軬饭鷭仮蹯飯飰桳籵翻滼矾奿
mou=謀呣敄堥繆恈缪鍪鞪谋踎某麰蛑侔厶眸桙劺哞鴾牟
yo=喲唷哟
jiu=倃阄舅舊欍咎舏鬏匓麔玖疚匛樛萛纠鸠紤殧丩厩鬮就稵匶朻氿揂廄捄久乆摎廏廐救酒桕九牞乣汣僦慦杦鯦旧齨柩鳩揪揫鹫韭韮鷲赳究灸剹镹奺糺勼臼啾柾糾
zang=牂赃臧匨弉葬賍脏藏髒臓贓駔蔵驵奘羘賘銺贜塟臟
reng=扔辸仍礽陾芿
niao=樢袅鳥蔦裊嫋褭茑嬲脲溺嬝尿鸟
xiong=匂兄雄哅兇诇匈熊熋芎夐詗恟訩賯凶洶忷胷焸胸汹敻讻焽詾
nian=卄攆辇鲇鵇拈涊秊艌蹍躎鮎黏榐簐溓哖惗辗粘撚埝悥秥輦蹨姩蔫淰鯰年念撵鲶唸捻焾碾廿
yu=瘀谀吁舁丂鰅舆鸆與阈堉尉瘉蘌与瘐預鸒渔谕琙娛蘛渝琟騟砡稢堣頨爩娪戫堬萭鐭萮娯栯踰娱昱逳稶萸鈺吾逾瑀籅艅鹆遇艈驈偊鱊牏癒陓桙扜瑜扝籞虞湡硢穥衧汩灪豫鹬驭硲籲噳扵虶灹遹乻穻鱼婾屿聿媀肀隃预隅悆予誉銉芋芌麌于亐貐粖邘語纡粥隩邪窬袬骬媮蒮钰育窳傴璵庽庾郁盂髃軉鋊惐盓雓裕嫗棛諛棜蓣雤雨雩僪峪滪棫飫諭狱櫲狳蓹竽鳿漁伃圄鄅紆礇愈圉愉輍欎褕礖餘愚伛礜欝茟蜟謣欤儥欥錥鴥挧鴧嬩鴪圫匬蜮茰鬰霱鬱欲崳焴唹鬻輿楀獄杅饇歈魊蕍嵎潏酑鵒捓蝓敔余魚嵛煜轝鍝歟楡魣祤奥捥奧彧兪饫畬齬罭睮楰浴腴齵歶蕷譽慾馀薁喅榆宇玉龉箊嶎斔玗玙澚斞澞御妤澦禦覦醧熨喩妪羭馭螸禹禺喻嶼於込羽鮽閾俁迂迃揄藇緎觎燏痏翑寓毓秗寙懙俞叞矞域旟燠鷠淢俣淤釪忬语淯鯲鷸俼篽臾
kuai=會駃儈蒉塊浍脍郐擓块哙鲙会巜旝鱠墤廥圦侩糩獪快澮狯璯蒯噲欳鄶凷筷膾
kuan=歀梡鑧髋寬欵髖臗寛宽窽款窾
za=帀咂杂囃噈迊咋囋襍扎囐雑喒鉔桚臜雜匝沞臢紥雥紮沯咱魳韴拶砸偺
geng=鯁埂莄綆縆颈畊鶊鹒赓耕梗絙庚絚绠郠鲠賡堩椩緪挭浭羮菮刯更羹峺哽骾焿耿
ze=簀庂昃稄鸅咋礋蠌樍瞔嘖昗则択皟沢责澤箦侧耫責溭笮謮崱舴唶蔶帻灂仄汄則擇泎諎捑襗幘齚滜赜矠啧嫧择睪啫迮齰側歵飵泽賾
zh=栀倁瀄栅者栈栉砋蠋怍逐耑砓怔砖怗蠗這栚堟砟値瀦砦砧蠩株砫耫逫倬週栴堹债栺值蠾蠿聀灂硃聄偅衆聇恉聉遉桌职桎聑顓塚聜桟灟衠偡桢塣塦偧遧桩偫填桭恮遮衳側偵衶灷職衷灹衹硺塼灼衼硾肁傂炂邅墆墇肇肈梉悊碊墌梔袗肘炙颛墜袟袠炡碡炢肢炤颤袩炪碪肫颭梲傳債炷墸炸傽梽袾邾炿肿胀棁胄装郅惉僎棏烐飐胑郑磔胕裖磗胗磚烛僝烝胝裝郦飦棧磩僮壮郮壯棳飳壴惴壵烵飵棹僽製脀夂脂礃椆夈礈焋植椎椓褚鄟鄣椥餦儨礩鄭焯褶愸椹脹楂煄兆祇襈祉祌酌饌酎兏腏煑祑奓楖祗奘饘酙祝奞慞腞煠照襧楨祩腫祬祭煮祯酯襵慹禃憄妆醆膇醊禎妐榐冑禔馔妕憕覙禚榛禛妝膞覟醡冢膣榨熫妯妰榰妱膱覱馲馵馶妷榸膼馽姃准秇燋駋种重駎駐秓槕凖秖觗釗駗槙燝針釞槠駤懥凧秩凪姪姫懫燭槯觯駯觰秲駲燳至致觶秷臷臸臻秼釽樁戅騅戆騆戇稕战稙稚樜樝樟舟戠娡鈡刣娤爥戦樦訨爪爫爭騭種舯戰訰舳樴制娷稹娺稺診騺註樼証騿詀鉁驇穉鉊詋扎橏驏牐詐鉒詔扙鉙驙穛穜詝詟驟剢婤橥鉦执剬穱剳剸扸詹扺扻驻找窀銂劄窄劅誅犆窋誌抍銍媑窒抓骓劕芖銖折骘劚檛媜芝檡窡骤劧抧窧芧助誫抮劯抯犳銴状芷銸銿拀狀諁櫂嫃拃拄諄狆諈櫍諍苎諎諑拓鋕拙站竚招櫛嫜鋜章櫡狣嫥諥櫧竧苧择櫫嫬拯諯狰竱苲鋳鋴嫸諸竹竺拽髽狾笁茁嬂挃欃謅指鬇笊挋茋笍錐鬒挓欘猘猙挚錚笜挝挣錣猪謫振茱錱謶謺茽茿譇捉獉證孎獐筑卓捔譔捗筗譗荘鍘魙捚筝占止正鍣譧孨筫譫歭卮荮筯歱譸鍺鍼歽鍾宁讁宅厇莇莊讋掌箌厏箏宒箒鮓厔宔殖宙掙箚殝讝掟鮡鮢掫鎭鎮宱箴殶掷箸鮺鮿叀揁证篆识诈築寊诊诌珍珎诏叕揕寘珘菚诛篜鯞珠毡揣诤篧寨只诪篫召菬菭鯯鏱鏳篴菷揸诸篹鯺诼篿専调谆專氈氊尌搌氏吒琖簗搘鐘萙琢簨搩谪鐯尰吱搱鐲谵氶搸琸簻搾籀汁鱁鑄鱄鑆鱆籈汋瑑籑豑屒籒豒展摕籕鑕籗著摘属摣鱣葤汥汦籦瑧周摨呪屬豬摭呮屯摯瑱籱葴瑵鱵汷籷豸摺瑼粀粂蒃钃针钊鲊咋璋粍璏咒蒖粘粙沚撜沝鲝撞貞钟咤粥粧咫責貭咮撯貯撰钲蒸治粻沼岾撾沾蓁擆瓆擇泈賑蓔峙賙糚铚哜泜瓡铡擢铢鳣峥注質蓫賬鳭铮哲擲哳擳鳷铸賺糽鳽擿甀蔁紂甃贃甄贄贅鴆鴊甎洔紖蔗锗洙紙鴙崝贞蔠崢责鴤紥锥账锧质紩崭紮贮支洲鴲甴紵洷紸鴸锺崻甽贽紾政嵀啁嵁終鵃啄啅镇浈赈浊啍蕏絑赒赘浙赚畛浞啠畤鵫啭赭镯敱整赵畷絷長絺鵻絼长斀嶂嶃嶄喆趈喋斋喌斎疐斔綕嶘閘趙閚疛薝斟喠趠喥嶦斦綧涨鶨斩綪斫斬斮疰斱涱斲喳綴斵薵疷斸疹疻綻薽趾涿旃痄症藋淍旐痓跓鷓淔痔淖跖旘鷙淛旜州緟鷟藢痣跦旨跩痮跱淳巵巶藸闸嗻緻旽淽鸀丁瘃瘇鸇丈瘈帋縋帐縐专帙帚渚帜縝昣渣縥帧鸩帪瘬踬中昭踭踯阯嘱嘲帳縳瘴丵瘵蘵踵阵丶縶踷鸷蘸主昼鸼帾幀幁乇繇晊之乍幒織幛湛晝湞幟陟蹠噡幢晢噣晣陣幥癥虥虦鹧晫晭鹯蹱繳虴湷晸智乼陼乽乿庄躅麆麈争隊嚋嚌躑庒躓蚔準蚛障亝嚞麞溠庢纣蚣庤溱皱蚱暲隲皶纸隹皺皻纻蚻隻纼皽囀蛀軄盅蛅织终仉绉雉軋廌曌滍盏囑仗蛛滞盞転仧盩軫蛭曯滯蛰黰仲直軴黵軸軹黹绽伀缀鼄霅鼅蜇震輈輊霌漐眐霑缒輒朕眕輖众蜘漙蜙輙缜朝眝眞真传张弡眨鼨伫圫弫札朮术眰朱漲圳漳圴漴缴張伷眹眾輾址着罀坁睁佂轃齄佇齇睉轉佋齋潌轍住轏佔杔靕杖彘睜罜坠坧潧轧罩潪杫蝫罬转睭置彰潳彴潴轴轵彸轸杼坾轾辀垁征侄羄辄澍徎侏徏枕瞕垗辗辙枛侜羜徝枝鞝徟螤侦侧瞩螫枬枮徰侲螲枳徴辴徵澵徸瞻螽瞾濁蟄蟅柊迍濐翐埑蟑志柘蟙这矚柞翟忠翢柣迣柤蟤埥查知翥俧埩忪矪迬忮濯柱忳埴執柷矺埻査追
zi=缁吇茈茊渍紎鄑鼒洓椔耔谘錙輜茡栥眥眦鰦笫紫漬鈭崰吱锱茲倳稵輺甾訾頾訿頿赀镃资杍齍子孖字葘啙剚孜齜畠荢恣嵫呰呲孳橴孶牸虸兹赼湽籽鍿纃鶅玆龇薋禌辎趑梓芓沝榟鎡粢趦咨澬貲鲻璾淄秄緇資姉姊滋胏菑滓仔胔鯔姕緕觜嗞釨自嗭秭髭諮秶矷蓻胾姿
shuang=孀灀慡欆驦骦孇瀧双艭鏯縔鹴礵泷鸘雙漺騻霜塽爽鷞
qiong=琁宆竆筇瓊憌熍銎桏瞏藑茕瓗睘璚嬛邛儝煢橩蛩焪跫蛬卭焭藭窮穷惸穹赹笻琼舼
zu=鏃組组倅葅诅卆珇椊俎族鎐卒崒祖怚詛镞租稡柤箤踤唨蒩崪哫足菹鎺阻靻爼
luan=亂娈羉鵉虊孌薍巒欒灓脔挛圝圞鸞臠釠臡攣灤峦滦孪曫銮乱奱癴卵癵覶栾鑾鸾乿孿
heng=桁衡涥蘅鑅恆烆鵆亨啈珩横橫姮恒鴴撗悙胻鸻哼脝
gei=給给
gen=搄亘亙根茛艮哏揯跟
lou=婁嶁軁僂搂镂娄剅髅溇漊甊陋蒌嘍簍漏髏樓篓廔貗瘘屚艛瞜鷜嵝蔞摟寠熡鏤耧耬謱遱露慺瘺偻瘻螻鞻楼蝼喽塿
wei=威鰃鰄縅尉萎帏娓谓踓琟頠瀢渨倭渭爲蘶逶帷为尾幃桅偉艉硊湋瑋偎癐癓違屗硙衛衞葦葨味葳詴偽媁隇溈隈蒍暐鲔躗隗媙犚墛芛躛炜撝媦溦碨沩犩骩骪骫纬撱梶亹隹颹為鳂胃廆苇磈諉軎磑烓囗峗瓗鳚壝僞峞惟囲围维蓶苿謂愄愇欈洈圍猚蔚伟崣猥洧餧霨唩圩伪未猬鄬唯儰椲蜲椳崴餵霺蜼褽蔿轊位潍畏鍏魏煒嵔饖浘潙蝛煟蝟鍡捤煨卫嵬慰危荱楲腲罻捼潿醀喂厃瞆讆薇鮇嶉讏斖涠鮠喡覣鮪徫熭維微玮螱薳喴嶶覹懀矀闈揋菋韋巍痏鏏韑委韙违叞韡韦寪韪緭緯藯濰燰闱揻濻痿诿
diao=刁誂貂调伄椆掉碉鮉吊訋窎簓钓弔瞗銚刟鈟鼦錭琱銱弴窵鲷瘹調蛁鑃盄汈凋藋屌雕扚鯛奝铞魡釣鳥蓧竨絩彫铫虭鳭鵰叼鋽雿
dian=掂墊傎琔蜔店碘簟颠椣厧攧蒧瘨垫踮澱窴电玷嚸甸点阽殿鈿钿淀敁痁壂扂橂佃巅槇滇蕇奌蹎巓佔巔驔跕槙顚靛顛癜婝橝點敟奠惦坫癫嵮婰癲痶典磹電齻
pang=旁滂螃逄磅夆嫎龎厐炐龐鳑乓胖膖沗嗙庞鰟篣尨肨耪眫覫庬徬胮雱霶彷汸舽趽
yin=圁朄洇猌鈏輑伒霒愔訔引洕瘖堙茚訚鈝鄞吟崟蘟霠訡夤氤阥蔩霪唫欭蔭崯縯吲阴茵栶堷尹圻瘾筃歅慇癊硍乑噖齗湚婣齦絪荫婬慭湮癮饮印陰酳荶靷赺陻噾梀銀隂龂檃骃鞇龈禋侌璌粌隐喑蒑碒蚓垔讔憖憗冘嚚趛垠隠鮣殥斦銦窨檭隱溵殷檼垽嶾犾螾誾裀苂寅闉烎凐廕囙懚滛铟因珢鷣磤胤濥濦淫蟫飮駰諲飲音廴秵银緸狺姻櫽峾淾韾泿
wen=渂榅伆抆炆文蚉紊缊蚊紋阌鴍刎妏瘒辒縕脗鰛殟玟瘟芠螡鼤温溫莬鰮鞰榲稳肳搵昷纹璺閺吻輼馼鎾閿轀蟁鳁饂呅闅駇問穏顐忞聞忟呡彣瑥闦繧穩韫塭问雯魰豱珳汶絻闻緼鳼桽揾歾
chai=祡袃瘥囆拆芆蠆侪喍訍差犲柴儕釵钗豺茝肞虿
zhuang=狀樁庄戅装妆戆戇梉莊焋庒奘荘糚妝裝撞幢娤粧桩僮壮壯漴壵状湷
yong=悀喁墉踊涌咏蒏栐愑邕鄘颙醟用鰫甬鲬傭澭踴庸永愹怺砽銿擁慂臃壅牅鱅勇埇勈嗈痈灉雍塎俑顒鯒饔癕牗揘鳙苚镛鷛雝嫞鏞詠柡佣惥拥槦湧硧彮噰癰嵱廱泳慵蛹郺滽恿
chan=搀儃欃谄簅嬋瀍阐谗攙缠產産刬崭丳儳瀺嘽鄽酁譂蕆蝉摌浐獑单剗煘灛襜幝饞硟繟幨顫艬孱鑱摲啴婵繵镵剷湹潹潺摻嵼冁嶃嶄禅蒇讇馋纏纒讒躔劖誗覘骣颤醦产禪單閳梴嚵澶螹掺斺羼辿燀緂苂諂韂囅觇巉鋋棎忏蟐鋓毚廛磛僝鏟闡壥裧蟬铲懴旵懺滻緾蟾
chao=晁鼂抄漅超粆轈怊牊劋鼌巐炒樔鈔耖觘鄛朝钞巢巣焣仦勦眧弨麨欩訬潮仯焯绰槱嘲窲吵摷罺煼窼綽剿謿
xiang=欀蠁缃蚃銄夅項鄉餉羊鄊薌鐌羏向嶑纕鄕芗銗麘栙香鮝鲞庠厢稥閧骧享萫嚮亯箱儴膷缿忀廂闂襄鱌响啍降像曏襐晑潒蟓翔瓖衖緗饗鯗湘葙鱜饟姠乡橡象驤祥珦详勨瓨飨佭跭鑲想詳絴镶鱶勷巷郷饷相项楿響
nun=黁
zhuai=睉跩转拽
nuo=蹃耎喏糑榒锘搙梛娜愞橠難穤糥懦搦懧傩鍩挪稬毭糯袲袳儺诺搻逽諾难掿
fei=妃暃渄猆萉朏霏斐騑蜚騛厞废吠馡鼣肥餥榧鐨砩匪笰蜰悱鲱昲沸誹费肺犻費芾疿廃橃镄靅胇癈扉曊緋胏棐胐狒婓腓婔剕篚飛奜蕜屝淝飝非飞靟櫠啡翡鯡廢蟦橨陫杮绯痱菲裶俷濷柹诽
dai=待殆垈箉袋鴏帒鮘甙怠侢傣貣簤带大蚮逮帯岱玳戴霴帶贷貸瀻紿曃獃呆靆叇瑇柋绐軑毒詒诒呔廗駘軚懛蹛黛艜跢代棣迨軩轪埭釱黱蝳襶歹緿
fen=炃弅分朆帉粉朌枌岎砏昐羒瞓鈖鼖焚馚氛紛訜蚠蚡妢玢鼢愤憤梤吩馩粪隫芬躮墳餴瀵羵蒶纷膹鐼鲼翂黂坆濆坋奋燌秎轒燓竕獖饙酚鱝糞坟蕡僨橨幩奮豮衯雰魵豶黺棻鳻棼份偾汾忿
dan=砃瘅眈贉儋唌帎萏刐蜑訑伔甔頕愖褝簞紞鴠餤氮霮匰鄲丹弹耼耽嘾弾聃腅但彈噉癉襌饏单赕啖酖啗単癚衴繵聸呾啿媅醈妉沊抌疍誕憚殚窞撢撣嚪箪殫禫玬躭單亶掸疸澹憺膻皽膽馾燀担胆蛋惔擔黕狚觛蓞诞淡僤旦柦賧髧瓭惮黮勯石駳黵郸泹
kou=敂彄簆寇鷇瞉眍怐眗瞘竘筘窛佝抠口扣芤冦釦叩滱蔲摳劶蔻宼剾
xia=傄丅嚇暇下鎋瞎夏芐吓夓瘕閕鰕縖辖笚螛疜閜舝霞侠炠騢匣厦徦疨唬碬颬圷鶷梺舺谺鎼轄罅煆廈翈埉磍狎遐瑕諕硖懗柙烚鍜陜俠黠峡乤硤蝦珨筪祫鏬狭敮赮睱虲呷蕸狹魻峽捾虾陿
dao=刀刂禂嘄嶋嶌箌導倒搗氘焘岛纛隝舠椡檤螩檮隯到帱禱稲朷嶹辺稻悼梼軇蹈忉道壔艔釖盗瓙魛盜衜槝衟翢捣擣陦叨絩幬捯裯噵島祷导鱽燾翿菿
shua=唰刷誜耍
xie=縀脅脇瀉褉脋蠍娎焎蠏谐夑爕搚攜謝挟谢瀣栧樧洩渫缬猲紲伳儶愶缷携褻挾慀血齂祄歇孈奊恊瑎蝎协絏契屑協楔偕齘齛絜偞屟蝢齥獦噧屧卨獬絬襭塮偰繲卸灺衺靾熁邂纈颉綊梋鞋榍膎鲑讗写些斜榝躞媟躠嚡徢薢鞢薤龤垥澥劦炧炨冩邪暬榭鮭嶰械亵鞵撷枻禼碿僁绁胁泄懈滊嗋糏翓擕韘藛觟解緤觧諧廨旪寫峫燮勰韰烲燲揳緳叶擷拹蟹泻
zong=碂縂搃鬃樅鬉倊騌猔骔宗熜綜從枞朡猣騣縦倧焧熧踨踪堫疭昮傯稯縱瘲纵椶鬷总粽總潀鑁緃潈糉繌从嵏総鍐揔嵕棕蓗腙摠惣蹤潨燪翪磫緫偬蝬糭鯮捴緵豵嵸综葼鯼惾
shuo=搠鑠妁烁獡铄碩槊說愬洬説爍銏数朔蒴说硕欶數鎙箾矟
fang=鈁鲂蚄埅眆昉坊旊祊枋鴋堏淓昘匚紡邡倣髣牥妨眪肪訪舫钫瓬鶭防芳魴彷汸方纺錺趽放仿房访
shun=橓蕣眴瞤順瞚顺鬊瞬舜吮楯
zhuan=専蒃贃專甎耑专馔砖漙颛膞堟鄟传簨撰傳縳叀囀鱄篆襈轉饌僎瑑籑顓譔磗磚赚僝腞転蟤嫥孨转啭恮諯竱灷剸篹賺塼瑼篿
xin=伈鈊舋锌枔鐔昕愖炘莘辛嬜阠妡訢欣邤礥馨伩脪薪訫馫焮芯新馸釁心忄衅鋅歆軐襑顖孞廞惞囟信镡鑫噷噺杺盺忻俽
shui=睡谁稅帨挩說説税誰祱水说氵閖娷涗氺涚捝脽裞
nve=虐瘧硸婩疟
tai=骀态斄箈鮐鲐儓溙钛舦鈦大太抬冭嬯檯邰枱炱颱炲夳薹肽珆跆籉態胎汏苔忕駘酞孡擡奤燤菭坮台汰泰汱忲旲臺囼
tan=檀儃榃覃嘆谈醈舑袒倓醓舕昙貚憛傝錟探攤貪贪瘫锬炭谭璮墰醰憳碳墵弹怹澹暺憻嘽钽嘾弾燂緂顃壇曇談彈罈摊僋坍歎罎忐痑婒惔灘譚坛壜橝湠譠襢坦滩藫潬潭鉭埮毯郯痰癱啴繵叹擹菼嗿
tao=鞀逃萄醄鞉騊匋討掏鼗縚涛謟弢縧讨蜪抭涭檮洮搯綯鞱夲夵咷梼饀轁桃槄慆嫍幍滔啕饕套淘絛詜韜駣濤绦叨裪瑫韬迯跳陶飸祹绹鋾
xiu=鎀貅樇琇锈綉嚊褎褏馐休螑璓袖脙銝羞庥脩岫溴鮴銹鸺咻朽宿峀秀鵂潃鱃嗅鏅齅饈烌繍飍糔珛繡俢绣髤鏥滫苬臭修臹髹鏽
dong=鶇栋垌挏鼕侗笗鮗霘戙咚徚东嬞洞崠氡墥动鶫鸫冬崬氭倲涷昸冻娻岽箽蝀懂菄諌働凍硐燑峒烔動腖姛棟鯟董絧駧胨湩狪恫蕫埬勭揰東苳胴迵
seng=僧鬙
ling=錂龄蔆领〇皊袊霊夌琌朎羐鴒掕霗龗輘領崚羚霛稜閝霝欞刢麢昤蘦爧炩澪岭笭鲮鸰砱玲舲鈴伶紷岺嶺醽綾孁棂柃酃铃詅聆姈婈靈蛉跉凌翎狑衑苓駖竛泠齡秢齢令呤蓤另軨淩鯪绫裬燯棱菱瓴灵陵蕶零鹷囹櫺坽彾祾魿
cai=寀裁婇采啋棌才扐材纔猜菜毝採蔡財财彩縩踩睬埰偲跴綵倸
guang=広挄桄硄輄黆俇光珖撗炗僙垙炚炛逛烡潢咣廣臦銧臩茪灮姯胱犷獷洸广
cao=慅嶆懆嘈草操肏慒漕糙襙艚鼜撡鏪螬傮屮騲鄵艸蓸曹愺曺槽褿
can=朁参驂參叄叅蝅嘇穇囋残湌儏餐薒鏒蚕骖慘殘爘慙慚嬠飡燦惨璨傪黪惭憯澯喰孱摲粲謲黲蠶篸掺蠺摻灿
xuan=琁蜁愃琄吅儇蠉选愋昍夐蘐谖蔙贙鰚嬛昡縣漩眩伭怰萱弲渲萲眴券縼瑄晅塇鉉煊繏衒蝖譞镟絢癣楥楦轩癬選鍹敻睻蕿讂暄玄暅璇檈梋媗鞙喛宣禤喧袨炫悬箮颴妶暶玹碹咺县璿懁痃鏇铉旋揎矎蓒軒鋗嫙绚烜諠翧駨泫懸藼諼駽翾
pian=扁腁蹁鍂楄賆片篇騈骈偏犏缏覑騗骗騙谝諞駢鶣媥囨楩翩跰獱猵貵緶瑸璸魸胼便骿
piao=漂飃驃僄飄嘌殍魒慓嫖飘旚闝瞟顠骠勡瓢犥缥醥票莩皫彯徱翲朴螵薸縹篻剽鰾
sai=愢毢鳃嘥顋揌嗮腮鰓毸簺噻赛思賽塞僿
teng=縢螣驣藤謄熥虅邆駦鰧誊痋儯膯霯幐籐騰滕籘漛疼腾鼟
chen=莀龀趁贂趂鈂霃樄榇沈沉墋瞋谌瘎麎莐謓栕傖愖讖尘琛碜肜綝茞疢梣夦訦醦伧瘨嚫儭爯蔯辰稱螴谶宸踸抻趻薼偁煁諃跈陈敐鷐齓嗔齔鍖軙賝曟磣臣迧晨穪櫬衬桭襯称忱陳郴塵捵敶硶諶棽
sao=嫂矂掃慅繅懆氉臊鳋騒搔瘙骚溞髞鰠梢鱢螦扫缫繰缲騷掻埽颾
san=厁叁糁参參叄叅三饊弎仐閐鏒馓俕繖鬖傘犙糝伞散糣糤壭帴毵潵毶鏾毿
zou=黀箃緅菆搊揍奏諏鯐鄒掫鯫陬媰走郰鲰楱赱齱騶棷棸诹邹鄹驺齺
zhan=嶃欃嶄邅醆鸇栈氈趈氊碊搌榐霑琖怗辗嶘战粘閚薝讝颤嶦戦斩斬枬崭颭戰覱栴谵蘸瞻綻皽岾沾輾詀嵁旃蛅惉橏盏轏驏飐佔展饘站驙魙菚湛旜僝盞桟占偡噡毡鱣鳣虥虦飦棧譧譫鹯黵嫸詹绽鳽
zhao=肁羄肇肈笊钊箌垗趙枛朝鮡炤爪爫昭妱嘲沼皽瞾着罀啁櫂啅兆鉊佋駋曌诏旐詔釗招狣鍣照罩召菬鳭濯燳瑵赵巶棹釽找
zhai=粂窄宅厇擇夈斋齋嚌斎厏摘鉙捚哜亝翟檡责砦侧抧寨择責祭側債瘵榸债擿
cheng=騁洆椉程娍成瀓堘丞逞鐣琤騬脭爯挰稱頳搶氶阷鐺朾偁呈睈罉塍饓橕塖橖乗靗乘橙摚牚晟浧穪赪筬赬酲畻浾絾承晿荿碀掁澂澄憆檉骋徎撐撑憕溗鎗檙窚悜撜瞠誠抢枨宬侱庱净竀矃凈城裎鯎蛏埕郕棖铖诚盛铛僜泟秤棦揨淨埩惩鋮称懲珵蟶峸珹柽緽鏿