niang=ᄋ݋|
lun=@䗒ǒKՓi՜bFEMS݆_ھ]
luo=Mc_im߉Vz因ܔ{`iᰍbTsZJ}BsRzxÇIjTjӴeԛT茌^
nuan=ů`fq
dei=ÇN
bai=ٔhڪW߰ؽ]vݒqܻobB[װ
den=OY
ban=L{DΌEkCRkї擄n锑ZO雖At[mꭚ✰X쇰
bao=dAЈUه縝d~ڈ󱧌pb汩hJEd}_ذǘ̙tfܱم˝R豪
zheng=w@gc~k~bPoՍڍPtۏ^@֤֢͊tCՊ֣kPA݉^ں῰Y`Jdl
lve=xDԮGﲌs
rang=yȿXÉj׌vZӠ}K`
you=eXޜ͜jŐJ́JMIQiKɮhqݒu[v~뻠AόMRDכSīL~znXmYlO`٧h܇TݯݬxyBUāݵ̔fAhԆNљ_|xfǑɘҍr]ޔH
ran=ЙvȼzхGcЅȽLYVȾȻЀ
fiao=҅
rao=N欋ƘYvķnʁ_@
gang=ޠ߸Ԉ՘ڍILՄظs֠G۾VٟןM䓈
ai=XBBBK}ۋLsaӰ찤GgtGl}ͰP\avɰoȑᑹỉacoGLߔȔ@ٌrv
an={؁B@씰݋jϛYcK@톆֫qHs霰ȀIƍ^WQgVɎOOC璘u눰st폹
ao=刁Hn`lᮝTjJTCĎS֒֓b|᪇qG\֓xRSWUEEK໒UܳOO
cuan=Zmgܞxxܴ۔f鷉ߥUTU
kua=vF٨芯\Eڏmg~
kui=Zkd퟿|ظY఑躈jiĄь`Tl]Ӳzw୸Qr̀AujwhuNۓʉ̝Kv
ba=ZEqѰM҆NXjҙ᱒iy߰ɊŠ㲮T[RְԈBڕɍQ_ϰƅǰy^ᚰՉΰ˰Ȗ\F͆^ВUTRj
hang=fRнW@ކsVߒaؘ􌺽Ժ
kuo=vQ韇ppAUSHUNtTTu
kun=㧛~Oт^KjAJ逗yTXdǍHhG׭@{
bi=ɖCא͚sFذԱɈ]oKPڼEWaƱnKP{PGwPfxzۋvSٷ澜gƲD`VbݩXܰnzKLIv[\][؄aЋHzΓaş޵Eq@s赱̯RCߛYSa±S۱ؔ^ګ@םٱȱѱرz{Y\v`ϱԯwɜƃ
bo=cGNY~R`۲缞jothDŇQUKLPq\ȕq}K@ࣰhiXğBNA_J󲭚RޙqnCFܰBCJಣNogm`pCcߨ뢠˭`zRtż\k\_
cen=᯲θ久N_d
hou=JjC훕ȉ`_cܩ@ƙFAfJ\Tˎ
duan=FњуЋeZY呾fV϶Ș˂Ha
xing=ʡH_]dUSn藊԰ɛh㬹wmDꟓМ處ȊBQꀊtyߩqMw͍o]
bu=ɞrYbͲJQбXcpq☲яELKҲòa߲βhiGmѺ^^[
huang=umepыhMbwnmڇc鍢UrBY͉ESsϻŻͻЙŊUķkȓNNxȏԅ˻틻ǘRRW
sen=Iɭؘ
ca=͔cgn
a=Hĺ߹簢
b=vAܡ͞dWECl҈ޱGJPTjWlƂY屳킿GKLl˱ܰwǰB߄߅ЈaЋJƵ㣗f՞ߓܞRϱMߙRBCTߛY[JڃFGj^k_l`n쩰a`RTfԲαk^f㹃GJòرVRXїoFBàJK{pUXzMŊRgoq`ұbԱğ҆v[ҌA_rFΟCEFSgh኱ĜAضtᚶzXvZgbkޘˊ˷AeٷHK␲☱ŇEGŌKǠŐvyq[\Q緅mUu@\ķTѠRޙqŒim~cp~Š㱧bc|·m^opcϋxՕ՗ݒppԸqtuNƃتWcYޱذԱrQWրplqtɹPƱLxêò߲߲hi㪠ݩX[QrEauIv׃^NXUnqfgmp}@םȱϱѱOЌÚǘSȰ^a`ȌEdggDbcɲssV~]`aİɓeiEqͲ°M\PQO^stȕeh}M꬞z{х؄΅aؐӓ赻ಥCHpໟSDOQ蘲ڛyLefͱߨ뢭ꭚ\GmP\م^RB[XɜɞٔKhٙdENFuＱܱ®gڼnODLwPP]}SG亱֛®llࣽ[\]aߔʍH޵rs@̯RbϾXVaڕ閲雔xAzˍˑ\nMW˝ϱԯw_`ҕKLYRQY\۲KcoRmhv̋ۋݰTΜ̙Ʊ̞@Vhհij_ٰnKKLqMӜ߰zdرorsCE󁘕{؁YKR͓͖CD͚±yE݅}Mp[ԁȏaZсӈedKhf輁_ӈmղDܱ{ۏНTX쇰쏱ΌjΓ@gDkl爗npqSxN㖩ވؖر҈vh{nIȖĳFlMȱłp
ce=դԲu޲YɃRZพyȹkm
c=ῦyդ؂}uxXYIHSmQTx݂n˥ЂړuțNBӻv讳Hᯉ֓ؔһߗc߂鐛㲂ߥnŲ×藏xٲڛɃn{z{ɐىɘŉݔcyN@ﱗ胅͍ܴPxynQ߲̔Ƽ[tÐgÜGAP͑FKaL_MNŮȘB騍ȍemFײLui~Ȥ~څQăIБþZċ\\]qěڝՎmcN갴P۴|AЄYW\|^Ԡq]nȘڜyqx̄pۀ_mv㜐ᜒŒAz̑œ~ISAHz[rKuܰf{pdSTUWʇ͜ZqԴƲԴՋgyѸ}o܁yҙߙYƉ縒^S۴ցƘMĴe֍ݏŝyc|]ݪղĴߴRZ˝ʲǌQCkΈJ\꣈ޏjseȴǁui@oӫouǄuyδمZDEJ˚ۅWB[[Ə륺bPdU
d=픳Nў^ޚWZݞjޞDEFܦKLwCX}QnTrFXgς_mfp[qrǐzyىyֵ|\ىbJԵДصOߴMuVXYڐE]ۡ㵿C]ɐPqK\}dːnؐ´t}◹сbуDՐLэחZÖ鲶BDEqHRLGH붵PõdVZGJbNcayd𝵔]l`ʑ~EGVV\WRđd]j~AghEដ~K[\ʠcӆ^ӎg[Ӕays⇵Rymൾ⚶렚egrŎŏ򛠩FzŕAŘřOdLXPJYXA[beܶnQ㓠Էsٙ|񼶯AiHKָL{Wҵ]ՉblǄmՙ՜BuI˸~{K|䔋ƒDA钡LыVYZ^`caSXuyEB僴𵥅gQY[􆵷TWHmݶx޵y]M|}Z[\隊וpט욗m赧ǅǇڮCڱCVWǜ߶Кö_WaԶKlصy煬Uvк玺bִ挹hI뺚KoNSKxOŚ߾ofȘp͓ǶXOT˵ۓړؖA_cכkJI{ߛuOUἓɅFBɉyـJeuGٜSHmlLXOGtv߰ｆz}͍kHƔsжĆzࢆ}ᔥÍɮprʎʐѽxmमPzghAB੍DFr۶kRؾEYԵځHφcRWZyA઎op@LˋFWkGLǕAtQyDֶ^MNہGྲྀӶɶvhڎoviyksd޵nDwۆyQې}ۗꉁcJε@BdׇWHꝇO啤DYIQȇlfZoāðq܀@܄܍^KܖIcBhDUlnrtfW닁덁綶ж͞to͟뚵ܱy~HKرPOW\]X[^d_͝׈hmkVŖsaw㏬y{||}δ^eòfΖ∑ƁC얚CɵELHԵJxޖ^bሯ▱ޅއމ~d큖Aʵψܤ̵ÏʯGޓ}Sσ׷R
ch=tϊejȈJ]^JѳadO𞍳܉@qsW󂮉ScpnguoėFjtmóܯЃ}^߆L␑PqDE{ꐝї㰗JYv\]㮃bE}~nʗgʹlmn颟Lѳq×U{~׵cAsחƗ}UqË݃ỖlDALJbS}OQrbdcgor鴵ǘZyqb~cuҗwhxp㿶UY~뾻gĕ鶑eӄIAW͑O|汳ԠbaG\VۻӐɘnŊ˴ⶳHxiNrkQWɲ潠ꠟxyIMő}ȠKLBCHԈԌBےQ濄ԗr[S˳дB|OfƄa㉠˷SrsX\ߠ♄kJxvӸRcSVg~ՀȲ𙟠aaɸeiՑrzϙڄR䐒ً֙nsNƏƐT_k˒HI֚NM֝F~FKε{bf嚹flnׅq^_޳׀x\}ׇk׉׋[׏pj\`m蚎k巹ݻ旺@ǈFǓNǔϲPKZXמǠ_߳cAGp멺oNjOoȴ衅畬bdo߅ɴKtⓘIՓdXaql聓򓽌}˓γO_،ճZelnP{ioكɔwDEdpٕ獃qv^|蠔~abոcʽIAr[뷍󳨮WXKLMҽമݮսdf䳬ӿnD}MIzEچˆδgR鋔ڒlbgڙf\ʆlCmJuOUFz͜QՕCvˠBICSUѲ쯄EևLةد𷴮Pwp{߇bc˜iۂl̎ی\ꁿAVʳ·WNPءpsX˰{򿇸hJćǜχг܇ɳ[lܕNʢrSŜ|T놳I͒{돝Rԝ_ڳzSk|ݎrݐb辱CXYZlociupxsƖ~QV泹Zγ޳_ꡏl٭uDIu׏M{]^oފދ@eٱލBsǳx{m|s
e=FﰳSe흄ճXtI㵓tJӞOP~cbi_q㍬湇fYLrEF]~ʂZd[`جy|{x{vL׆Mx@FѐݭH鑊dSވܗA@Ŷ~kiīQuz
f=⌠QxMQڳWSvϛͺ甂N皷ɞ~\Ii寈mM󞒞߻ȃS߼OYafukvLorPQǷОǸ֌зГЕߑ[ؓr޷ʉhL؜@෾O仙T㭸kooд^ΗMc^TpcJdiMۮwcxySɗxDfIoLJɒPوqbWَXt]}hiчqټ~ߟr[ӟu򸦵\ڼiiѽEެLۺtpܸTwy}RӊOʄKʆʈniʍf^͸󸹊i҃҄҅m쳘_evwBXI}ԑOy~鼃OJTćw췽ďVړXtpluEƔǷᜄFGKCNO򎈶[ӇdַaPӌSWpX`a_ӟttwJLpht`~Tŀłch츽C|BR̒VᦠDJꊸnklbKcșlhܽ_`]bVAmFKkuĠRԕ稸ch܏Fj|GՙUDG뀁SvJݱ`ƅ䷶k͗BUfݖD˷̖Foθ}Khm˱}ANBfDƞݕpݗTݙCz]bbeiMNڷlǷع[qJі{PuXUz}rXHʖliV嵝bc㸼ݳvs摷AYhʷaQEn킖¸ƂnOٺɷ̷
ci=υeNΈJ@rFWyeǵQiƘodŴ̫upcǄ\]yŴqՖٴʴڝyan~˂Bڴ
ming=bqpD㑖LiڤK⊱QԚu
g=TUVĈ؞kH䂉E֖Mquѳw^isܪrkbI˗U򢉁IӴL՞ָظЖɂНNW˴bߞO@hF\Z۬QD߃l׸rvxӉR˹Љѐ^ԉ럀ÙekПpABEIN^Tص𛵏ݸҋָҎڟsbJژo棶WMQ^¹۹󘆸ėØkmQSGVQZy߸궒hZou}mo΄j_X۸YblЄM^ԍOԎRԓtԟ_Qg㔙uAa㠹_aTUiƙչи{ՠ䆙ƹƂY͋҄g@⣅CƌݢgƗ]ƚQdTѪnتC֏hmkKpOD偸vjԪ`lEwmcwyPVd\Yk칇ݸsiqmsq抅vڬ暹HǐǑڴAڸѹTžÅ@^ھqljkٸάgόJ롚𓕅ϸ^Zø𓥹bȑhdi铱ɅN}xFœٻړѸƭYؕ繳؞eFJ@ߦyWuZw^Y}M}ɀsA蝸RNyWzkُnfgtﯼvFCwMyƹbᔊ󛲸ĽCӮu䆘\ٽbciҸӽoʆwϽosIr@v[wx|ʾVQ[]ڑXY޻`ikKPøƹ}~긯p꺾˛KQ¿SؤHXcQuحlێO|뜈H|I{fԎ_뽸ٸйǬwIځ}ѸޜİwBبϺ빪pڰm@U͹g܈܉x܏qvV͊WYLṀÝL\_X[ÖH{݁l݄ٹݑז_٤찏ݞΝ变޹鱚PqrBGGLq꽈xغZloΚn}zR۝ڸW|UX㲎k̏岕u沛xzjJʳM
h=홞`@ϖmĐHϚMܩxD_hjUghoYEuaлАhغ㻸{|mkohҞ{߀ЄE򢺷ۗcKHЎhߒ򫻼Qߘ@ARhۨCֻ󐲗㱐ĻݟCaFܺ̉֟QػtWZ[jѵCʻzыQkÆpёⷐミbcdќfۃ߉ۼࠟŻ͗JENﺨƊUۃˊ_ΟRVßƊk҇o}sHnڟUĊ̟슏mGioDESF񔊬ˊΑζ처Z񛘬{_A׻TepӏϷpvbd›ẽ򠒑XZFŊkIBxԅԆşOԋGMԐԒNOpԜxb_^ShmU㐙ud|ju_I̺UfdffhՒnՖBwC՟ՠsyM~WRefE˸ϸyƒI⩻\ƙORBnk֗t֛B֜xx|@܌AXĚZMV只a喚gbݦeAfD@oLqAw{Yfגa`twڧ总t乔rڭEyC~ʺKNڶQՌWڻ]AU_fZi\΅HLdMnuPm{Ʌź瞿ԅƓGADEFqJUDYZԬ~UȇȈȉYÅغ_ȏcKsmoǛNȝtR}؀хIͅZ[׻ћ`؎諓V_ؘ^؛黦ػghȺᲆFJARVPxwߧܻ`~S]YNN@Ucߛ䧆itbv߫GkMSy]]d䡺ػBߍCJWy䰽`bޥ]佛ĺƛȮIwͮ}ޮAX޶C\DboๆuxC^{ްڇKQԔX[闆rcߜB`HRxTXː\꺺˙WȜX޽޿COIԿSFGU_SoaP׿efamWez|s_xa|َΕsjmF{s[vͺ̏iϕ~]̖̕DEׇޕ\LqjQׇHϺ㇘ʕ򺿻DyY򺰂aఌĕaɕSƏ@AfBXZiں\zn߻oq؁ܟܠGhj͔dA딱nu͠HMux럝hKL@tݓJ~[αFefgκ[SZrEuݺJNO喁T~썝ܻԻሆ앝`ΑΔΘΙΚvHҺG~ڻՈ_貑[ކn@CEFGiޒJ틏Ps
j=wޛDhޟIs_`cfMʞk¾᐀׼܂߂ߚHBۣT΃_PceG־hսԟKqr`y۲ӟ]adhÄqÍÏ}ÝC柔KƟW[콴_`ߑgμlxvґznuĉ摠ĔĖᎄBEHHQSTUJ[]Ց֠aVYݾ˄WeffZiu]ߑx꫄fgٽo⛼q⠠ŉޠM]ŝŞe脐DSqܴ˼z}]ゾǄʄ㚄ܸ侢`zŒ~[egmоntƄ޼ĪE߄|䒄S䟄ƈ\BEGЮؼƖZ\ƛmoYZܒGⰪ剒Mⱅh񪗪ݣmݒԼGIOuPYoqdvʽӫikǅl~}扒挫wݼABѫ~켰վ嫃TRVǚǝZГ[ǞBbgBGߴ~Q袾\珓|癓BɬnLpwW{Ȃȅabi۬ȗ{~Ț胬誾葓ĭEḼ̌Wғ׭ZXح\^`޾adҭnuؓ⼻DHOTɓɕWCɛDhk︔s|Y^Ô`┌׆mԮvzخ{̾ʅ㔪ާ븾ʗNުQ౔ܮECKfgܔϾΔІҽN]酔j־Ҽu캔^|dˊȔɼsΕMRSEWZ^Un\z~̂ʕwxoݽ}ٕU̗̘X^򱾰DnԇuASXHߕYiǽehؼݕuԱMÖ́}͎͐Ȧ͝rKAODP`V]agfijlnoCtwysܽR΅쌖]쓈Ύ윾KvJϲ{MQZ[\dǈflpѾqüt탳CςϖͳOVǵϕϘK\ϝ^УR]afiVADIyJAJw|TЂA¾D՗]GЍgkmМxZ}IKԼ쉬WZ\쫉_|ЗմᴚC@駽KMTѕћeݗߵfЊAHFMO~QI饽󼢊X鮊\HOPze}Ȋj҈҉Ҋno\ҏ˼桘cҙxIҟkJmSJPSV^Xiouxpb{f毘⊦n񒼧stӁEӊӋӓȶӛ;EI٘۷MS۷Tڻd]benmيp@ӊ@CK溷}MJԑWYԋTݙ^hHdoыmvwx]ze}moMދՂpՇՐՑtxGý߸θٙǙ۸Cə݋͸vֈb֊֔֘nRHVIKH޹UyU􇼾^__􊾯ajtvzJL_{cX^깉ƚڦoǚڪzżĚ{ڵJL댔]asurɌxپܺCCDFӌE켮RW]CbDeՌ֌؛GHjqJۼQ~؆ڻ؋؏ᵾھstvZG]`bOTvjF}فKيjϵZmo_`Bm䮼ȼ~􍛍䤛ǳNGHUýYNQ^RUVXeg˽ov{pq~ڛѽb~kl丽@z{|@HBDNGڊNOPQڑWYY^f`aeڙonڠH}ByEޜQ|ORսVAgN]آ`Vadegp𯼦LMNۿx݁SٿUÁX忿ۈ՜Ŝ۔n`ϜԁfM۞ՁgOPUvBx{^||MQÎqؽej;uvT܇܊GH۽签ʾ̼^@۽]P^lTW]Əx{݋Aɏuǿ٤{BTIVW杉총UDYeIn٥ٮY\abɽď˂BɂCI޼ߝ翡ɽ\eďȞFɂkRޗ
k=ܥшҿpTퟐDܓtݳ`SWdԌ`muvnqAwbKM_KwbNmkdcwғ@㧻~~{ޞGЎߒp᳞܉RֿgyDFEL\ߝaߠrQhQjTXdۦĞ|蝼[h޿ǔUÉ׉v﬍y\ǃ~kтﴍٛڵLjￃ㴵Vfѝ𔎿ޢrП˽TǶ䫿󍺗K\_f\ʉ̿ϵy{_`|sPظfpA^ĄPڏڐ୘}Ēidw韎hڜ྿GCus~NwR@͑ȶPʄSz]@͆fOpSį۶ꬑjlOlڇ]⎿w̕p~ܠ̀^uvwpdŋHۓ̝GklՒXx[EFkҿN⿹UY㔕߿񽿺҄iDnLQwgSTTU{Yܒylq}@ҕܜ󂒈ՏWXAHAV缕adF^IKqrHU|QNHJ_ѝo@TCEto\KLM|cQ򿲱ӿ׿Rj唿垪Kn٩Z٨]bgAͿѿzzpҒ݈ݨwzTt@܂VނǍڲpHUHߵ¿쌒G_ɿڿNLMο
zhei=
l=ϞZSz|gorbBΞ{|Fegւߞ`~ޞts|@¯߆߉ߊ㦐EÃIJɐHXLO۪͟Ij[RfiÇ܃㶃ძÚÞ@۹BTɑX]flXYkzor֟y|좃rĂzėĘᑠADF݄CILMLMRRUˑР]٠filmrstv^zc¾yzŃrsŅݒA{FŔWś@AIい㉠΄ՠӠڄ«_̈́XZnsڄ£xJ䇄䜪[GƍΪdƔbUhVjnyNiǪ¬±VѫCGMݰʫS`W̒kӅyݹ情°ݲǉǊB煫ǒGǗUXYX\e߷Hl§sROPy[眬fjDΓȄ߿ghnruxz|ȟ蔓ƭIUVTW]]ÿoߣsKޭz|svzUɇɈGɏ[]겆`Y穀]ޤ杖^ɝbɠCiRﲔjIﳆomnVﶔr{V|}fkήquʀH؆Jʙ॔RٮHJ쵔OqW݆ଔඔÔ@{ˀ˃޼ˈˉ˘r˞ADJD_`bd`hkmZqrگyo{t}́@A̅½¤̉ª²ǇtNOR̔S[]ꍰefgꑕ¡sO]_j`ĕɇΕччÇxÇ}JĹwxRX͙͌EJ뙈G띈J랈KTCPUFVG¶N^WYZ_``chޖs@AF|v΀{¢΋ֲkBtFNVږYe[io~ΖPϋӈILϜϞ`ϠBF[GHgbimCsܨtezWBgiBCnoOPv@­YЇµGKܮoKV~defimډnYr^vŴzƴ{e͉ϴkⴋo㴕飉素E页WXZ[`abўџ@sƗ[c~hYsatw¥SҀ»ҜEY]TaZ[e|w{񘊲@Ӏ¦JQ沘ØĶŶǊŘ̘ͶDtڷSfct@GHEPPKQ¿ԛ_C귕LtݙNvXø_stՏՓzЙno󀙵˙{əʙиFHՙQ}ւ֋֌تDjJˌCEDuGXa]^sVv\Cs|ׁ繂׎hiᚚu۹¨ڳDTIMNP\_nںt{͌I@LN[UͻV[\Ōһ^_kdm׻hjuvwތ|~³؂؋ٻlmHTURVHlbhͼZEqcهhْ~䣍otL因۽@ލ¸BF䯍нj`c͛˽tɛn\v۽כԾDFGڀ]^VXc_abbnښܾvnGIwyȎ{ORS·ZcPRTijkZ[Ir_wٿ|𽿆𿜋ۉۍێmۚ؜ҎuwCGva¹yzf˜hn®rV´[z\{|}_~kHqsx}~A؏IΏLC[ޏ\籏]cFuŪ`UVg©svʝi݆݈FxALO¼º[g]h^_`S[_ccg꥝ŏh墝ΝԂHɏ奏ZٵތٳgEILTVޘW
m=룳RBfϑ]ϟcU\]c`Qjrs}ܬ~÷C؞ĹīAJaKޞkĥӃoǉdz}pː؉|ÊTclxzDHZĽzF|OPú`MøЃɃ؟ðґaҒғҔڢCҚĤߘiMڤqRK[Ã튋ჃķmBؑF񈑿фLIX񠘴۠jØƘфbģҠ⌑·`ōTĲĵafԙԚwZPbýâiĠ۽uʄcĨ{dYǋĴ㙡rҙk狠ļCƄꋰKƀ\ïé䠋ikKMN͸փ^քèãևiֹFƟuIm֙w{BħIʒݤPîFBJz{VQ[eݮmjõĪ|ǀ担|sçǃĸFÿëǖNįQʬCH҅ӚıåYլ\Ӻ}׌ár裬sxzfȎ݅ĦxġB{؀ѭJò]؈͛^ûĭimIoQqEí蚍\aӔBCUuWɋقQV_ApsuêU}ZhómþopѮrҽQҍy{]ܛSTUYIhB}hdڛzircgˏPžqrƕFxGb[MJ_DLĢObXjp}Ĝ~z}㜄ñؿô̊İϜĻؿȰZ̎ρis򵜺pg}t]釱Ķ@ĺEIMNzO{ĬaܚRe͈Ŀ낁äZqDwMabüùgŖLMtu۝eĮ@ADľĩб]\WXψbcenEnFurtx²K{RS]閉[daٰhoömΛޫJϲyٖ󡲉W\iĳ_æìԞQ
bing=@v쏷ʬV\@޷AVKmm}T␚Smsv}hθpĽlu䉁u
n=tXYv͓rŭFxߚA߳eLlȂS]ZXHx_Ōa觖؞ۓĳD至s՛Svuy萞ӂ؃\ճSL̗jǐМАťZDiETUGKfPRŢXBğHMŴQpb\fFܗzMfÀ{~ԉHŧﻃxzކ{\є`љ߭Õ×ІFDGŨ~a骃XkŮū̃͊fʝ^ɘ`گGmũDű{HāLݶZxf|ēoᄶg[jjCĞEwq׶vCM᝜N|ųrVY\S֎WLcHQofhȜqGLǜہ̃iňۅŰJiyţؿDvFzbCۜFeŤkYpRܵ`\TfǕůjboŬWevəO癓ŦyчQҋًևܘyšrs͉~Q}䎏iZإÄŪ⥒ؾHrMDRظTӪeV݋ޱz݂[WŲ¹@Y٣ձU[r`PQDیMmaثuA٦T쁫DY햃ZLReշבΗyEAٯ~rsګǂO擝ⲅD|ǌIQFuTޑŵޕ
zhen=cIޱpZǿbw_j֡𲎞g驱\lGݟr䥻E⪀ZIꇉ`EFȜyP뵝^RАҘ黶GؑUg恒rڂEtm苏z䫂cL]}ᘸtFm
o=งŶp
p=v뫺qbܡCƼWٓs뭬VGHϙ\_aaZՓfK麒׳hWókBBƨq[ƫȆyOƸΉXmAykޛPuwؓƲėZЈƵɛ`Вc豛fȉSؚTbڍBقghGFYHޭpJƷgGhXi蘓͗gWߨƮɄByrưVԭۯpJ\ɑZMpƿƧʛJahٟ궵FGĵIьPXvƶ^۶귛Ø붟jƢAEGMlơUbNdƱFžiTk@u[mr{ҐҔtevo@oPITćwƣdſ]iړڕ雔psAyAᕔuKQƦĶyjVˑƾnMRWN泎GOѿTkاXmn]M_t˷@^ИuٷKskؠuo~}دݱⷱƬjEƹuO۷oDYۘ|շƽEu⇐bMeq釛kvfg҇ƭqŒhו㛠xߠRꇶp퇺BƤgynoj|虝k󋘋՛̓PևtEzJNgƻ_ƴθZƯ䚪TeC䞪WACJܱ~O݃m~݇ܝpӪpQƥtwǒwL\˪V\msƺƩTBrWGu`QlΓoq@ƳrݳϫnҏҒrQKݒƪFǎ҂_eٷUȖ姫HٽhMfkgT
q=ψޝϓǵϖܞp^N@ٻRSlァovszdِj͐n|U~ǲŞwȷǡE|wpqRųWxFFȲߌJǽQȧtРvEX\ʴ_`AۧLa創lnSȹ[wxldmV㫗Wǐăsbwz旾adCԐٵJ܃ѐwz]oIǻMUȫ[acdhiTdstwbȩQpHNȶUY݃檘lnkĚaJjOؘPp񐘤sHTUӈӉ`ИXTUjәꨶs`c`gGqɑȢȯ|򌠝ǰ@hslQ~xUŚǤKŠNԏQRǣ񷠿ܴ]Lԋ]ŋ`ܷaVܻVWȰpZ{۾ȮEF왇uoMf|ĸ[\jՃ`Ո͙deՍgl|~uڒ䒊yHȭˋܪX]GmtRSǷWXJLm쒮۹H\J@Ko^Lǧ}̌AǸtJVS囒ݡ堚k@oRȴls@ǩݫOF^ZUi嚄j^鹈ll煕oȥǆxDEڰGDȡIK@޺RڹUǙǛº[ǟڽcBbjIݽelynzpqWݓzĚǫcAǴj@lAMȁ[OKcଆRǺȍ]`ȓFc擳ț芓߻xDGᩓǥ᪌᫭SWU`˻ǮǯEǦȪZg܍g͍nɒVZ@Pkzoppqﺆuwz_gϼǾǢnnǳP䆓ǶwޡÆh蔪ϔjkޭou^c}򽍽ŔCmN|JȤLڂO־Nڅ׾PڈډIД鉾_j׾eږsĆȬBk}D~ڞIBM龃ɾIT˕˖ώΜ[\Cҁ@IZآ^TUֿXYrHbm䎘op޾yȳrăȵۄre~jۖHМ򰇄AR畒qEFǬ`mxONTBVX|Z[ؽd˜CDװLm|ȸdFǭHbܙǪܝ@Z͉͋粁ӱ[͏XNzAbȦ뒼ԝ\pBځ݀T׈U؈XSǖ_ǿȱ٤ȨeaҏRi౞mǱ轁j݈oxw~΃ΉȣǼ`m֦ǹtȺuFBGIǹz{JOXǨٴaހjm]沕bgٹDKHJNγMτ
qian=`kXojǵpqt`RcSǷX݀ǫٻq彈T׈Ug庿yǴS@@KnǧeǳvǸ㻞ǶǰecRQUǱǲ`ȓǤFݡNkkRҒRalǣdwqqǬǩ`xûxdZO`ܷᩓǥ򐌂ߒ牉|Z`plP{E煕ǮǯǨǦaLndGՍ]ǭbǪRܝOcKɓb\TZ
yuan=aFԲeԨ͛ц@ƊAmԵxwOѓԹj뼏ԧQ{RԸԳԪ@ucgԱJmhԺCܫzztAԬӃ߇ԴԯWQOVgԭؒԫԩߖܾrdM~ewrԷԶT䗥j԰ԮY\Srx
qiao=㸁@y^NAaJw~S~ɍ@REF]NV֍Iڈډf`Xȸ[΃SDm|~xɄǟ˖ڽǙˋNsb
r=GМchHUњ欠kkmXrϔӕmnZ}^}ޞqdߖ᎚~kxYʞZ\|yټ}ӒCn@B㬌yGߒPLpIRMzv]ЀSꗋYG\ЅJfevMNSߏM`Й\NvcVJGrmMewۋ~؉ܐƉܛǐȿJɁ䄗MtP輻Ɓ_VeƼxørnƎÅOђcXx݉݊Z䲃ȻTidc탵tsVHTҖkYFʁjQʇpٍʝިq\z~jŮAkYQګK]Ƚь`΍c׌gľBtspsߟךxČ޸VbwU}_]eȼzqgǌ䅪ȾqO񌘟JiӶV
cu=yٯ|؇mKcuIȤq{ÐڅqA[ۀ
s=r˞[wǚ힓pqRwiwɦzZX]і˼قvC盂ʺU쓖|OTɣPlɪifpVB̂|FCL˺㤭XЂһsߗtSij\`bcqpִfrotRʳVW~wɮ⸉ɭۗai\ِwcnM훣ؐdі㺐囫јؐmtI{`ɢBԑZʑʔzʘʜhȽdNtDҖgxVLjɬT_~龶X޴˹Ď{`Z˽ڡʟɤ˂@Si¾݆˒ʆLՊIKi涿WlXVɿ\˿ABտiTlɥpsQَV˻𸯙}[d򓿓̌hҘۑzuwɨNRjɫZrXVXp{ɧЩaM@wbSCFrߜɩl_CՁlmďP󁙸rZ끙ϒ󠸌qYqLOɡET؅WFRDŪsƁ˪vئ֠SQBK\ݥOygmoqrQJݴ]x·쑫TaɯjirxA{}˹捒敲β杓HDK^aזݿٹū}GhzЖƚ˾iemܣo
t=̬ܢ͸[;шGͨLȳa^cPZjkntXvf}wͩzhTͣe\HͰ͵t ߂ІF㩗^ڐ̻ߋǉlPΉЛ̿Y݉ۢU̼[ĉfgNbk̥U萵ăci۰NPӐx{{|oщlяÉÎ̫ÓущͷnukDyBx×̪QLfUͪ]_c՟ȘW[qg]aAdқKGNןCĀĆvWXw_y齶dΟͺję`~CM񍘤Q͹_BDܶPӑjlӚqfv⁊nvͧBqޘPзr|ACLEIH~gnԘՙ\U̴KͻXA~܄PͶX㔠Ջqҋsy̧qIKewRTh{WՄbl̦wlpͯHIF؄䌋`Jp̢zUԋ`lGͦͱsUYͲTɪZL\c̡BjnثHݱDxׂ]_hTdh]̽xjiיǁy{昫}LM˴W߶\Ą̺̇̄[̾IEJiԵ̸|ͬVz[̬_̷F͡vF̯GLךȋTZϻXB㬕̭L㬟蒅ʻ؇؍хл\؝AfkkGGpNMLC譃yɂQͭdqEɉɊɌ̩a寮gɗxZ䀹`l}r\̰鍨kFٽGEIKxۆWdʃYčɽpUrZyr䮙Ϳg޽qST΍ڄ郾TڌS޷ۛپgڗcef\hʯ]lDaFo@ʹOfLSY[˓˔̵@t˕HTE@L̤`꼿_sRgeevḻ}cdqūۃرÜp̣zۇۏ۝cWDJݎU̜GcPͤͥnՇŕ܃VuWv`ܔOͳŇ̲ad͢]͑ͼGIшC똁DEػF`wbNܝfMN|SyILC]zݝ菗d̮b屙lj٢̳sp١fnͮH̹v̶r٬VΆͽ옶Ο@ʂDNͫOKUM߂Qޏރ߯粘cw躈ޏǏm
x=φ횞aύѡѷϐϒՂܞnٞtУ嬞yԖDORVPYѪ_ƉHeaгwfj{kijdr_dDfϢ@ĂŞNx~Ϥ]FݐЏФԂߐnߔОаWPϮеXYZ[㬴cDвeۧ퉮SۨDMElqm񉷉ۭjϧ@SσgUϩmLnr_ʉٟTӟX˟[{؟^|_рlAm~cфqхFϦxÃ̟mWUÑÒy{hCDqֵm@샴ȗ}AGVWШɊQC⾵puvhUϨڟҊn_Ѭʵуۑдfϥ|ҠP}BMܰ摐QąZzč^c~㊐ᅟиi꘍ĝፘ@@BDiK毽OnOqƊXwM{Ҡ^R^}``ӂCӄϡHb]dӍdogϷӒ̠wӖxyӜrD|hFE׷GKM֑ݷPSw海SȯV[{CwnŖԂMԃJԉbNcѱMQSԔѨoVZԞϬϭ}eUܺSO㋠̋lܼ㐷㖋r[^^񿋀оϱqNOtPfT\nѫӠuՒÄmתA՚t՝FC}vxLP̪L𒐙ϪMۋX[ք_ĪVDjЦlƋoP֋xЮϻ]aך@An֐줅[Hv_֞@qЪ@̚RcЭf[]z^_ТJX]kѧlݡdO⳪жWrMIܹqwTNzb~ѳ_Snאݷaz{ѵqrnѶ乑xݲtכ搚޹ל曚M𫋫TSѯݾVڼ]^`aҶ]ѰnFoIKL{N}Сгwyκ}믓y~נ{лekЯB@GHRGuw}LPRSϫ`мȊ\^Ѵ`ѓvg΅rl肌݅zڅ듽̛TUH诓ȓ٭PR؉ʅY[AһCDjߢ̆IݭtvLNйMt[I{ؼNQϿtϳߩY蝭l`ZقɒsXкϵ{ޣrgQmпDsϴRKy{͛Ǜ䪻npLЧަXTekmTʌVuʒʓY|Хʛ`ʞ@½ýiGцpefivAѦϲбKpLWZޯN{GPн~Q`MO޹NQTTZ`闆rkdvmjw޺{ˁ|e˅ˆhSyѲMоѮKоBюBEHXBCϣRQETlJ[]\c]hVdϯ^[u`^bԇetvḂ꿍运Gqޕ}u̍̐ꀇx镁̓ےϰCѢaGꈇ̟M_۟TClyϺꘕcJѕӇϾimo򇠜vw϶{]Щ~Kah鰋ϪU핻򹇻G^߇mp祇̎ϸBԜ֜ڕ܌܎_ɁѤ̀Qضv͂NݱSѩ끏`e͍]Gٱ^_ʡ͕͘ShݱrdϼҁѣIӁݍıŝsYEUK_ݠMhGЫdh^aqkryߝLM}ѥyU숁W󣏹ΉЬϹfΐϽ윁pΘۏCj˲qwѭm{ɖвvxPPY݂SSಆѸ`T󬲏]ⲗs`ԏbłckArFv톂jyзÂrQޙ
z=jfiy҅όr~oϏѐId躐֨opQyz{VȌj_ZegڂqȠ菾ƳFզ˗_ЊQߤdeg҂ab؟jDIޭrխuYխF\_zc趃Vh؞~jɁmX_Ydنٍɛuّﭔeٛٝ|tuErN߬tij۸߃CMASSE]ʆީ߮aVPџ[{UaF􆹟оChڃsSڋڎT`k׾hͶfjltĠzzHKN갶}BQԾˎG꾶BRնKW÷Bfinkr∕fOvT|蠕ל`Łgk@tmۊND{sFۙIۛ땍UV࠼I㜹oْ[ddjiTWxykg֕ڋQP͸Y^̴ӇՋՌjvМs{{J}zەיndAƆ@`KOwіQƓf{Mʝn։Ɲgiݖɝ|֟ajUJ冒IP֒`bBYSGxivw֚tPU솒St{RgccnדftɹׂF掌vǈ~ށǏK`SYZCORD툳Ide`U
da=]eAoR͸pׁδ槉QN^Eޅ઴_އ}Qzމ}J[Qσ
dia=
die=glABWсے䚊ܦLCyAHHiBޠe]uOUgŎ@ՙ蘛GLx鮒|\PW
de=uĐf؏ԐAz׵õN
jun=ЂyzAhaSKqx㗔|Dҟfzܾ󈭿h܊bQR}U޿FJȚBTE
rong=]hњՂԓm΍rϔg߿^Ǝqsђsx܎VݷZ\cFɬٍ񌘟횿qtPV
di=֘SHbصLMޞEOvе۵ܐK淵̏~ƜvڵرysD[gXе͈hmkFfۗVdy{rNpdݶޏXٵꝉyh\}FbJZ׶EДƖӉYELVڎRۡI]Cǅ҈OڮlCmh՜ˋ馂dWBǜɉB~KAWκaef
ning=H|_̃ŢVޙFšrA帔Qf
bei=Kf싐ʆhuv㣗fR䱺Fؐ@݅ic|F^ǱLÂpˍT{GlKmȂ˓dpDN͓
ben=`SǠeЗyMQ６nG౾ϺpڗL
gou=¹kTUVhÃڜϹѐНMaۺmv_찯YgMxڸ^ԍxُx
zui=dS@iE`xKީBfBT䎆rU
diu=AMG
gong=\t@C˹yؕ㹬mpbUߎErTbykün
tie=cuz@FGN
du=xƞ^^ܶ`GLΖǛטɠٶCGiyXoƭ{KbAǶřEo~V큪ـ|Ttöt
zuan=F߬g@jgڄyeٍjS
zun=gJVVIߤ׍
zuo=yzgՋЊ򶚿Ɂs}ܴйizFd
jve=_`ݳOf~uܾ]珏{Eܟ}ZɇoHHޒ^ٿә@ʅާ֌巇D~BQbP|kҏXWҙx؏@ʎDثiNМޫkjo`ڑXiĔpǅpqtӁ
pai=fW۹uT݇庒ŜkٽǏg
ren=ЌUxJӕmeMB\ךZGrʶeg̵sVHǌkܐ͒PɁzJ~YΌV
pan=ʛebοTGco_T~ćgQ닊q雖jOAmۘPb_
cha=pO\^߲lɲ⪲뒷髶gۂ農x鶆dőK嚲ԈԌxQړc汖ˊga
pao=ڕ쎊E蘈EЈ҇ьPasˑBڠ^JhN
che=sF܇cqpJފEeݳubLس߳͒
keng=@nclԿӒsLHU
ei=OG
chi=ֳԘs]|~k݁W߳ܚI̜MiAW~KXLM뷑JopcSgؒLVuolnۏt܅qdrdܯBN޹x߆}y㉈Lwl⚓چDhEYxnJvPȖ[БuދFn@BǠl߳qvEUs
en=CW
sha=Qɰ}ɯSɳfÆ~|鄒ɴeɲɵɱďBɼxɷɶǝEĚoo\
er=Ԡ[߃DpYrebX@ڍ޶EnLn^HXxzkW횾٦ss
chu=紦ZءۻܵAnsX˗،sҳ^aZzelRcb䴡IĕǈAa穛{IeՑ̎XNrbaizIXsǳ{mˠ|[G
she=χ^MhfhJۅz⦙O蓔㞗A{dLhsͅήbFʰ
sang=ɣɤɥјr
shi=դʦkF|\֎Ǖgʬ^rAYʺJPu˶ڬԇdԊmɁhʭʻȞv}ʪʴ~NPyTBKFߟʲbˍ]՜ʳz՞ݪHʿʨOLʰY[ɱciʽ߱sҳOuSxʧ۹EѠʾƍʮJ{bugR⻮tn]ΘN֟|ʹVֳ̅ҕZʵgҝɏʝ̌jtpݪyP\yʩʶʼጯaJʫʸlʷʯXʱPEɊ
fa=Xtzecʆ҉yPwoƞUzmVkl
leng=ܨ}قGJⱜ䍒k
shu=Ygd\ٿ漂H`ߞXfOXYݔ䝁󒼽RQxgPˡOPe_el̠nt𔵖ә]DE_[\CJqVܓTw^˟먚S
fo=u𗂁
fou=]v뀲
fu=ӇQaMv`_NɷJ\i`~Tŀc߻ȃ߼BR̒V᥋Dfunb֋chܽГЕߑؓ]b@OATFokT稸cJi|GMۮxDDIJɒbWَƅ͗}ݸ뛚чoq~}rӼ򸦸AڼfiݕݗECLtwy}ڷlK[嘽niJʍfѸX󸹈}r҄Hm_V嵝wcO𥸫ݳvsÊYhƷa¾ʎ
tang=蒑g|oڄhTGfKˇRySnU}CgyEyLCۏQOMĈnv̕詜Z閭
ding=rӆꎊֶ_bඦۗᔶOVYb}wBGcशkJ
yun=diٚNZyqżaюOBam뵚m@ʟs\C|ԱSZ[qʕy΂\o㢟CʟVX֒dQEdujؒljNMlܿa]n˴p۩JryTǇل˜Ͼ퍿A
ga=Qp܈ΫV긖Hؿm٤A
ge=́}wvϸ쑂gIdZƌkwwxiٿsnتCݑRϘėәwkx\PukMܪޠRZtY
yve=s_Ē`ԽSQRNV~xhgԿԼfhڌ釋^容[еjڔԾC܋ֶğܺMFXagԻl耐xE˵^Sd
sheng=ʡI}NŔ]ƖʥjK|o{ӠHָi}\ʢʤW啕ʣKTً꒕Ɓ|
gu=fgؿSŶĞkHEdM⍌ÙkⒼַYbݞʆqBMO﵏_𠹿Ybl[Xڬhu͛ZHÛ}MAŖ}W~ԃlLJMƂ
ying=h]ωOMlhKjAtZWӳPucөӪӧњ_ӣNAemt񨂟}ӬLG]f@Y|ӮjИDӫsӲ`HkӥӰӤs[΄򣕣tӦIkӱH{ΞvQDwLLӇӨݺpcӯ܅gOwӭaxI۫A_Ӣ@L팙љ
hua=ÝIΔpɖfWj_kA֜hXynՖػiEՠDEfAԒNOf
ha=UrϺx
hui=䧞`G_͠ыHxD]_Rdsq߇j㟐@䫊򜓎MvYޥoBxD޻uLeԐҞN{}ԜwbЄ^CDH}mDUY๙uΚ_dҭgtԲ~ڻ⚧V@x`zߙڶػݟCTaFSE]˙M_ΠZޒihjP
he=eMҟZAvϴSϚMyzBnXZؗ柌mYFFefg[iÆԆպǺt҇؀хE򢈆ЎΘuxHKuQaJ̊RڭAPAyBw֐HKǿᗪCYG _
bie=areM̋XֱhT
hun=d[FԻ[M鐸Qk՟EoڻGeJ@O윳ȝ钜q
huo=X߫f͵[o冸nmd뷠^؛ߘhtɻx[_ZoGWş\CN_i@޽
bin=\ƳWĜƵefٗÞlxߓWEϱ̞hPIٞMpl_
shai=LkɹYɸi
zhang=wɟִzʲdŏ{۵\ǯqΏÛ@J냸̒EёPǁl~obL
hu=WL풺nOIESϷ˵CFUu{HSPeIObdg֗tX䰁[ɺ̏m`叺k̕]jsmκoLR~_͛ZSUΙC|ڻKĊᲹaXÆۺi~ܠCUΜW@처X{G~Uغ댂s
xun=r[ӍѷoQՠwӖӜ߱䭐en_R_pަhS\xѴdQԃ_ݡDOѱcѳѬRѭ`ѵѶC޹ZZѸۨѫᾉĝ@MѲѯFrѮFyeѰ`ޙ
beng=pܡa괆G잊RԬalıeJб¯ngMaȾXlEŁȓg
pei=[䞔hCf΂_vɄr\aSk«ኳpy]ޖ
nai=GYؾGΗє͓٦̂ޕYirܜܵ
pen=Ȇԇ\M
nan=૓DaϮ~{yo~lQЋRO
nao=tИiDjĞFψׅD觴LmCX[HثZup×ΫDիL
liang=yzngcZuՏܮvI|Zݹ݈o]@ÞW
song=̅ڡ힝YKݿAߘBsbԖZЍm捎ϑ
chou=򗹮oPׇ׉Eb{\hJIߒ⼗g~鲃㰳I[lǓ{NcłBٱ|OTמγnWԗbS
xve=HpƋoЏѦ}yjNGmݲxV`TYѪNLGŖKѧѩlѨѥ{Wy
hong=썜kt꽓ӏb딝YЌf`뼇avy럻pڧ{ް\鈘Ɯ|ݓADoFU镝~cEߺCZԕ{EffȇȈ{恛Z􄳅ܟĸs坭ݦKyȞpޮ
weng=ˍǕ̊TN\ΊOfRY޳wl
gua=ҹӚO҃oн\ڴÒ㔹Gՠ蝅mNLq΄IɟW𻾠|JTOԟ
gui=qlQ˗ΪgƗolQюTh_kۚ𜈹Ku^Ii{Z^i쵃ԎКwwZ𧄣фʜҎٙuYΚ@n|棅WqQFzڑWߞO`@܉F܏}vjm͊Ƙ͹Wv
ji=AgӋWsآuRZae父ӛ񤼦cIfMn\𢎩zCC~DU]WʉIJbeۈmiޙC۔UnDŝK}^ȗMqۼW^nHQ᧼uoHvmؽ㚭^eܸY󙋼uԁu̙ՂBՑn_u_D|޼}}^KيϵٴoPDTżƈ䩟dOڼƖZ݋ꔌPVnmHQHTaVIW揟촹UyjhU􂮂􇼾^o鮼՘O٥䏲ުuYܼjJab]҈E҉llΎἭ˻@I|ƼSNJNjWZfżĚa瘊弰nڵfEȏlVsU퇯sgߴa
guo=xlXHsuR{Мub[JJ@BX偲^ǑI펽N뽘
gun=i݁حFPw統֏rɀ޹LЖ
tong=ԑq~ͬUͨջSjĀͫMLͱӯ]zͩͲhPʹrͭڍd١QͳͮͯHpUcIɌͪy̛nͰԘ
ping=JGҺqOƼ{q݃vZTfҎgrjJByƹgLuٷK̓ƺƾzɑZƽREƿƻukZ
qia=ĳslڞ֍gMUmǡuXʅ\Ǣ
ju=]ۏleD︟hrgI袕ZA^`^~qƾ⛮AۂLپ֊ŉnKٿVDe̘_eM՜j۞gJqz]ML鷙hЍX؋zXόaGߚxڪMJZIiv޾ďߛt~eՇ܇uxڠHоBTĂeHG|Hޚ؃h|`ɛR
dou=W^^]KLtfkHLzöÔYZchu^`aÖWKXJʶ
qie=ԗۧAj㻸`DCҖַlB@]o囅LG͉ӛmƎ٤檰m
mai=~]}{@۽AuXݤhI
tian=傁q\_C`kK[醊pTGgcVbk`lD׮xjpLqL\蝕񬙃̊ct]J
tiao=KxAqIVқlӎԋxiI]G{qfwxɂpfɉɊrg٬
ka=lQǿ̿
qin=ψ]lܸaVT﷍pZswWQHvד֬llOJݝdaz܃ߍ޲uǙڒǛຑ[jҒRBVCc
mao=ïаpéӱgòðґ؈؉|êu^èĜ~FórdñQímcFTëìEܚɋiîw
ke=缌fSЎtPŐfڵLpᳳ`ܴRWdPn⎿ڐ̚\}SĚMhwQ_˿˄wŋྍƿ~UGɿ ǺǿÿVzx
tou=WeW^B}͸ͷͶ͵ʋU
man=ܬAMNmϊáp׿zU֙zK枪\Z܋N`M
qiu=LWFӈӉGUzpFiqޝφpUbpzrH@ڂFGcM_AٴkE@hٚagbnjHpР򰜪Aɒw~|͏pUܴ
meng=LåmɃޫDΌimWXYp²B˰ZQ{sBw
quan=ebȦzXȩȰmgJȧȮ돃ȯSoḜAȪȬ܊IBkjZhjڹjIȫ񐘤wԏțȭE繊T
ku=ܥߠ\VڜFd⯉競s@HfߏWp޿ѝڇFL
la=ėǉmj`FrDyˈnϞBhXY|JY_
shao=ԊiЌ斶ҾKzۿʖppB}ןx
shan={դbA٠ӘӸɾÈ痓h۷Z~迄ȷ_ɼWXǿ`ɽi]ɿWXc^̂ߍޒ󉍉@ێEUڨZɺRܑ@៪Gɻ󵴊π
chuan=N׺@F˫[iⶴxbAExkٴݎwĴ@
le=옷ˏEW֒A{Ϡbiw߷IS
chuai=uਚI
li=РiPϋ沬Ps^۞rZϠGǿryŃNA{߿gOFWW[kPhKuބ~f߆؂ߊV{TW時lm_~j`έ|чѭHYnb噵˱Ĺeȍhx۪E䂱X{䇍qcc^䜔iۆotƍʔGւZ[`تџÚ^kZBӌCcޖs@]]^ɛV\sVv΀vݰׁkF݅r߶Yଅ]_b[ፃٵ޼wǗތٳ\P˞~ӀW
lo=
neng=Η
ruan=w\Óɬ}݉X퉼MOQܛ
cou=ݏ
lu=ZJ`JӚImĠtRoj}PB℮f眺f¾yh¶j́¸A½tc²¼ʀۍUV̔ºt¬ś±_ucF@zABnvuno|֫G¹X³»­S¯µ®r´rꤝڀ«F°oߣeTJǊVέvGGzLFJ۴{OIR͏]·eFuӀ]ޤɝ
lv=鵠lɈofڲkyoG|ȂH|@XE΍ȄvǙ˃LiyŌrH~ķ]¿`fͽV
shen=͖}ןcȱmsQYzB`TÌe꼝YIAJȐ_KhԖpr뷌}YbMݷߕsqL\ʲֲӼBυ|֕[ՔڷRvɆVlVBYv
shei=l
pie=ƳҔvƲȝد
chun=tNjaOc_XxTËƴك̴ɔݐ~QoùݻI
chuo=U旓ꡌF֊ŊאrzUf}qCpQ´OuɹSǾbd
nei=ڃFÕHMߛԊ̚
ma=wUl}WôiKIOΛMjĦ还qRKqrhRĨHa
pin=ƷOWƵɬVIƸϙDз|ؚPƶnAdƴ
lai=s|RjQ[[䵏ݞ|FHnvmsOXlA[D@`]gs[هZD
nen=\
chui=qD׵Nǔm
me=ôQN
sou=vσrȏCnLPಓgř˒}p޴њF\`bt
lan=fY魙쵔r̕׎ᰠ|_Ekmܭs[û@eE@{Gh[AL_hGE|CwР]hȟҀa
lao=S焍쑎UZguᄺxK~`ALzNXjo싪ҪJЙQ͌[
jiao=^ӊ]ɒ瀇EИȝ]УغUƛɒBwRݟIRKk̞pg̗_МU_͓qٮܴ˔νϽxǐqҏҙޕ׍zBİo̭dڊĉX葢ᆞ]ݽǫfHˊӃe᠄jнTtC½
mi=][dJik嵘aҒғ^ڢҚUߝe}Z׃jAО[}yms\oO͌BzQ𭌵z؍aȎCȜPדDԙJS
jian=rɽh`ǵVϕxp癑꯽BSݞÂd忻E{Ȃab՜W]bϽŞ{O~脐D胼Լx{|D߄gzI󙑓e[G`ؼgՐcOvGԴW䒙Z괚C\ﵔsȵMT̼`ֈeߵfu䏏ǳMOzN饼UYayʗGpIR齀}tv{Ҋfgc{ҁJ]Žl~KvS{VMY[Buڙd{𫅾}劧Z]Jkb[RGV
chua=H
mo=۠jԞfĢu]Ӕ}Įģփbքĩcֿ}\ٱxôQİ]ħĦġ셉sz{{ge؀tɲað]hĤûīĭĪcĨJNr_ĬaįCUˏĥ͈ƔV
guai=sՖԹy֖L
mu=[ъĹ]ģľĶcJĪĺǀ]}oķr¿Ĵĸyō\HĻĽٮļĲkĵaLfĿ날
guan=IFĘҋoXݸrӹvA]݄^؞egOQeھ]^۝暛H޲KqPjbTA¹`k߯pٛ}׵
zhou=bq{LaLc듿U乁q滋JBLgưb@kߜ@tNQQikBEBȒܱTBמHݧXFpSu
na=yڶgc{GՒŒfSܘ{М~ǆipyv
null=̃MLCiݔ񃾃Rx{eăŁbEҭkWHYkޑԃǂF]
ceng=}әI
ne=ŒfڱGګ
ni=⥿Q؃fރrDzāWe≁Õ٣v򙍋UyofɝvCMFNs͉Mruە\TuЗ
kang=^~KT`Hߒ֝o_ʿ܏{
huai=ёx݉ќjFx׉|
nu=ۂŬ³e@wŭūx
nv=\HZŮsSx
huan=d߀b}Pєk`Khoג↿؎aV߻ȻvջhٝG䡇̠푤Bۼx࠱ۨfA~J~JߧZ`SbqQBgXːO]IqQDoZÑ
mei=VZz÷[üùý]ݮCuoötûÊBõiË{mzþsYȈb`ڛҚiÿcB|PneúMqøSrƀCBd
kai=ܿa|M_bﴉNKԄGzG@Pǐa]
deng=ΙOOj~狃\ŘQŵƉʸ~R
men=TY{`JB̊ːȐǖFmjѕǐƁ
kao=@^Dw}
kan=M٩{ǶbRۼRꬴ||_ݨɸXK
rou=Yۭ~|ky`qnjÅk\݊kbQ
ang=l얋nna
lang=~똸ZńŅv͙ɋLHƖJOɇT^ݹ遬惉i]DqॗOR@
shang=A䘾Kʐն@yJLlpg˚vDօÑ^紝Cx؂l
qing=N핒䝘䚄pѮ_PH䃠ךߎAxՈ[͏Fi|mȍDWc[X
ou=^qTkWpIŻźtaUŽŸŷY걟˚֎Źکżpخ
pa=qutžيrſ˰В
chuang=VlyJ}SHk턓R
pi=aCWGC궸FاGܱ\tKKoØWƥƢƨ靇MYơdƩTuwBϐ`@[mQΓŊvq@RƤBƣYyKno|ikF닜yߨuƦĶyVۯfƧW
dui=B꠵qҔԴq煈VӉ[wAX}cmԞSy׷
dun=݁␪ޚdݓǟOgDԶۑڪضֶՉJqv׏P]H
duo=͒އDrDEsƶ⇉ٛkoWEĄm\Iޖ܀jwyzmAᔣsFkGZö֊bʶz
po=ǜeHM^Xb۶wƍFkͪt귱řpOᕟBUNȆ\ϏgkÞT
zhua=ץצtĐ
pu=brΞٟkmn璱O߲rphד귱붘ǎ҃Wے÷oVꆯj֖E姟MhT띪
tui=QΆۃLvׂs߯Uǘɏw܉PƷ~۝˔ɗjkM͑nhD
nie=WfבhRzbALO[[XTHǌٓIE܎qyؿQmǼbYDf}Z
tun=d݇pęvכ`ZܔXN̑l͏H
tuo=EDІhrzӚ[sPȳaeЛnÓי֍AkWXy҈ՂMFujڗرBKҚqؖlϘl٢ЁXɖsCLEԆ
lei=bɠC|hߴnGPL}ϜܛKWеX[qwrDaF{CYޭz̅ڲuڳNhIˉ[mtصச
nin=À
bang=ԽKo^RsŐ{r争YgDߙM
qi=ݽIآTUϓ烖Wәݶ݂p򀎩ќMKrj~ŠꋅQݗRųDxܻTBVߌJ[ӁZؽtEX\Ճeg[wܙVH粗ӱ[wzPX뒼dGԛuJBډW攌onoRt轆蔪ޭuhi}OsΉŔƒ^֦|QLOBNо_jޘeږsހĚD~MKٹsHHτ
niu=yMŤť~\FoţSjŦ
zeng=֟ٛ굿Q_Cf{IճD}gە
zai=[dكǏОDfڜPنPԜ
qu=za֙Y^z`J޾ȢRr^LPȁOdsޡxocx΃@tȣm᫭SȤdڅ賔Р۾CDNoEJULȥYm||ǆlnaڰȡlgJl@yTJ
zan={eٝˆד瑔ڎ`ɌvkA؞ۊmSaYZVٺd{̞U
zao=oŁYFҸ^r_rYVۛsbڋk
kuang=[EkpNqVNODLߝpmrqbTނYѿڲ_ܒqkj\ܜAǷHkڿn
kong=ǿ؈z֛I׿wMy
re=cǒ
wang=[\_ނ@㯖My^Rw͇ގWZDs
cui=譴y͂yެX\n~ռQăċ\ÜyWxPěJNŴݴ㘧˥
ri=JR~z_V
suan=iW{eg
cuo=A\vﱴxՋzWP̑siuHceլuzS
cun=~ߗY帀ݻv
jiang=΅ᮟ׽KvvxGYnuֽǿ֘{Qw\DF{筽TߊXݓ\P@{ڮ^
ru=rnNSߏȁd㜎x䲋޸}ʙM]dTCʇpJpMŮA]
sui=wǉ齗ZVp욁\ӊvSXjrĎU[l塭m`Bu\}wݟqraZiݴ]
chong=o|獃~\ӿؓ_یnuë_x諾rכZ
mie=`fIpҔfؿu}TPx_
suo=Fʓaɯj涜ŬRwWztiЩCіsRr
sun=p񓘓pSqV⸺{ݥO龆йʘXsZ
sa=cئ쑓۞l{aM_ʔQS`o
long=¢Ū¡YНVn׍zT[LdV{FHabN]oabL¤__粔oŉƻ\GU£TXx\t@
kei=w
se=֠ݝioaiNQXɪSwZɬ~CN끚m駱oiɫm
min=bRC䠈BhsŬY\ϟb}ẃI󔕄ǊzrOFݾϔقFɃoFxGwa
sh=ɰχդ혞cˣٿ˨T{OXY򂝐^ўYPgˡ˶}vmE˥˳u}ЌʂߍߕT۞ɵߟ˸VR[ʤcʳzʿѴۗɉޟY{gOSÈÌ֐۷ʧdѠ驟ʾßIuLɷSeYln]^JεbN|ɿVfYĶ@ҕטf@Uty\|\ßʼጊl񑘤xPضMq˰hkӘ˴ɾBׄhOˢY~ɲˬ➑ȷ_A֊ЄxHJJ_ԇLʣԊChTԖʻv]cbXyZfhۿlKƋbiՔ՜v՞ݪGHwɻʨL˩LƁʰQbBҒӸu⦒օfFElʮ즪{bӒOR쨚`iɸW啪oipF}}ɯ慄ֳZݷl_ʵgҚzj|ڨpݪq}x΅{|ʶɺ˫J匁ʫLڷTǝYٚ`ʷ˵XY먚ٺk˭ןSٌ|к]`痓˱ˮߓpʬ󓗌ʺQWˤPXlȐpnٻitɽprȞ듽D}NPɳ[CBFqKӼB{d]hżRpɆV@ڛ^Ovً[d٠JKHQJz`~e˦e꼝յBJơRӔ͆h_ʊɶeʖ֔]|VWX^EMjΛކþK\ERP錛ʩZAay{lVʱ˟ESЁAI˧}AN^ʦ\hſYɁF\UY\ݎjǕgbrxɹu\˰Pɕ霤dK̠ɁhʭtFo\ʪʴ꜁~ɴʲߏBܑܓpʢͅl紝BC緕Yʡc͖fiiʽ߱sm˷뗱s˪zgxʥXZݔwƏɱɼԱgA˯Ktʹ䝿ʲi젝ƖɲpDs˲JLy񖶝sᲝʸÏʯňؖπ
ken=ycё~̳wGϿo\
si=r[I]˿˼El˻DƁ̌lzKyʑjƽzQJʜB·|˺DҖLwtT˹F\{q˽ftal@ďPٹʳrG~hLz˾i
pou=rVgʒh
lian=nHՈ_`iBbj֋UVўSƜtac^ۚdYXI΋`zOҜ~Wt㚚ݲzIĘn͙ϘRɏI
tuan=؇oCщF`Ňⴧla_ti
miu=և
liao=lkɠr炠vϭVͺ͌ĂtԸNڝxɯXIfmēsˀێſiⲕoӌ׏\ޤ|GRْ
peng=MeZuܡAvlsJXĂo@~msupHsAygeXKmyUlinJykƻ
su=VChKTVXqMxXؘjBո@ixd㺐囫s݈TV޴c_շdՉOTh˂ۑipۗ
yao=ҫҨ^xsߺl[uP@{|ҥҢiزQrسGʹOnҡôfob]ŗΪңoҩșQ@쉚|ҪꜷfaЉ߈wcҤ׊ȷe㓂ҝűAlCԿԼҧaqGHȹ_ꚥ_陲|rutҦ׍ieˎweU̠d
yan=ӅJoVTwYЕVϊԑטPtߜ{zVܞ̳xVW{Fb̚cLγށmFGԝ}ZꚛWמCմNܾ{KyB܂ǦId̕f̙HijkmNssVS۱PBmeɋٞmЪ\͟e_ݟg[ъIݛ۳ËeBvh⃰ۅ]ٚPʗEDi|dzyZZׅҍ̽rחzڥɆ{ͅz_`CቛirstEvRٲcӃ
shuan=V˨˩YŘ̽h
ta=J쑍]̤dJ`d]쟂̢яNc@OœwkḄFeSYH[̡nDH˙\
shuai=˥ˤ˧ʿ\˦i
zhuo=~ϗ}Bپٓ@ڔۗzCVɁQ֑kXŗ}Ć׽vǚyՎ׿|׻S׾qr|ߪWhMmUO
te=߯Îc
ti={|羶Gpõf߱yvPGzDvXG}ۇYʃYHVX琊A酆SqʒڄYڌnӶ_e{Rٴf܃eflw萵Wm[Ӑɔ`
zhui=I׺٘KViՅ^꠿P׵JF׸dQ׹Y׶㷾Yܮx׷
zhun=qՁ׼׻MSƆބRdʈ͕H
mang=Mϑâå蚅{næMgWxãIäZK񠠽Ɵçܐ}ǃ
tu=ͻͿg_lޗ^ܢʯͽ;DEGMyL\ǁCdWͺhރIÓȋTWOf\B\]흤rQ͹؍xݱBͼT
lia=z
rui=GHt򸃶qfBǐGcިIJMiTƁ
juan=\z۲]Ȧ䟗]C世K윾ꎙÏ^睏Qÿx`闛CFĖhԈIZgm۲CǚI旨vԾCg
lie=imВQdFÇƔӠhVÎ_~}{M柭IvC`Yޘ
run=t򝙲pČc
ruo=eckxټU}OmS
lin=_z@V֭U\꥓ԟi߾DO좃kٔ銞ԕtUܑ򕐰O[ݰRCSېt`R[ރjrLCAHl
hai=@߀o㻹˺whnܿȺ񛺣QV
zhong=⺞Ư~qgˊt@\ӆW{ڣdΠзN׈Ơ󮱊VKѠ\wՖr؎WVrAb[p۠x{OԏR
han=HRiC홺Gu]ΝhKLhE֛JuϺ~aIbȃ˛NHAۅ{\cΑytHQߺUIº[dnnRwF\꺺NcAT͔
feng=҃⯂iȞllStԷ~hhmuLpITtK^TłۺAbpShRQKNOoLPوSٺQt`
hao=A޶껸޺𩝻ϖzƒ򫕵a^怕G_r|D骂ؐhB尶msh|Ւ]̖Sƺq
liu=[ήsµg]C]ytj^Vxsdefq@siAY񫀓Bۉ^vwޗBzHmwPg˘S䍗P
bian=ͮK\߄׃߅Ҍ왱urgf@܏lHcpqpSHq߯VxֱDЍOx頤ŌOO՗徎eXM꾜ԐQbc
biao=wgٙETYdr˟ր~MRl[FàGjklnAՕSsˑQќWlg
nang=Qe߭LrΑ򞏃
zei=efό\
zen=P
qiang=@藾Ǽ]\mNꨟmjǽb{uǹzIɫoϓǾǿߠĆܠ}ۄǻIǺۖŚHZ[ͬjM
cang=}Բزփœ@]M[Ioլى膞Pn
wa=e|cviڮ|农ó[ܜ퀝jߋzDm洌ܓߜBJH
qun=dtȺZ掠lnV﹄ȹ
gai=ŭy@DWȏw^ؤY|[BǸƖqi_ȑ}ꮽdwԓ
jiong=s睰}NޛyoGSTWEQѕS񒾼CsK
shou=f杔Ѕܪ݈lR緫Fbމ
gao=ﯸ޸woJca怉pX̸嘂޻Ƹ檂kǐ߸{۬zGV䆙Rھ˛lzغ
gan=QgC\sMθИol_ẕϫqڽCߦ|ϸ˸lv̏ҺThr꺱YNQɛNmǬU
nou=eAx
ting=F߽ߋ[PǅsÉNͤͥDcwKͦkͧ͡bbͣFHadjNP͢E 
wo=ֲY_bןsuiNCݫnhJxᢝğO՝PҒӁ}΁
dang=}^Dՙn崭TוԵځcXoW뺚KTɉYdř[ɵWhʎUЫ}P닮G
wu=FɊîWw\v뜃AroƕF؊ₗᛴHأcIWfg軍TMO@AؒG͒H^]NV䬐ʏ}ąt`|GRΏЭNI^F߫bu_`FꐚyĊڏP춹ȂWnoNޏT~iEܖw@J}J
wai=˞xJ
qve=ȸnȵ頴FCȲIXUU|UP]ȷoȴȶjȳ_ȱs`
wan=ٖܹ{wnH@ekB\TnÁXWiݸloؙO~|fUsT[GDdejv̕񕊉ϝDz䑽瘴
xian=Jn믓y\{h海Sϊ԰B¿wGRjꈞvՉd۟@ҋMyZꓓ̅o㊜w]ʅ^U򹻘GtTpMӞ܌jɁÀtϳ}g`xZ`mnsP̱]͘gQmhDDsϴW͵UҒǁݍEDvL傱ꆥ]mv}٫I`hƛ׫NҊ_efWM{wܑQ{MrvNݲztؼ`i޺@ˁ鑾OЈъ`Fo
xiao=X^VCСjEЦ}{tУFVD^[^Ч̇R̍k^nТԉʒ㞽Хq@ßФ~n[ząnDqYNfƚPSrnԚj]uدehSUv`jٙ
xi=ϡb{NϣϷlwxܿ]|GؐOϯuwPY@GH_}aqϫȐj^ےϰMGgbN̟cMϢlQS脒VNϬϭϤF蕂O̐؉϶{ߐKYAhϪϮϱj^OZ[tʐeۧϸtEִm_ۭϧvϳSؼYϩLL_ϵӟXĝS_qFlϦϴd̟m]aIy@֐[Uq@@c]Tɝ仪kTV⾖yʓuw@bϨ󣏹Ήiv㑃pϲϥҠBq~Q՟~S`kdⲗ`DSkݾO^MR}ӂӄ
zha=դզ~߸WlĜmƼեգdsohը~l髒AOթ܈էՋpLQա邼uzբ
zhe=y߆zؐׄmYt@·ПֆXzO֕UVرHzplJԀыExqVeߡKNuy
chang=tOѲqLȗǫ`䳢^蠳d_k˅鋳ɃCoŃYO㮳SρKlmjLcM䐬D
miao=QŋbFkRс
yang=쾔aYFBjfuն@k薕`[ނꈔSgt݌捤R^D^h}Ȗr֬PثZWoDąnIt뇋PDU
mian=PDŋiᆻ@|I|MdxE޲ϲeҾurtXགྷw
zhi=قu\ΎUϓwđ͂Jsn֨uƿ{Wֵp֭dayְ֮TUeەDEִ擴}WǒXЁvЉyÉ~I㇭MUWdVW˛b֥ЗИ֫脶nؠ\Kֽb܁ۤ}֯Dek蜙۪ͭ|ΜSTֱTTuO`⺋֬ٗ~ָeƇֲZa֩vֿ@ʵYַ֧^o흆wֹpjyelشeֶpFAֳ֦ҞEܘuĈH׏\UWcֺʶhboF̶q־ddvˌތ֪fּȄMֻǠ嘧SNz̶\]@]
xu=HӒݱrPנd䪚APSVŝsV[Hb֞qvA򐝅`d䰇uj{[z̐_̓ԂʌrrTUWӽ~m쵟۾AL[^аm䊐TvS[wþ{˅՚T͂MNSڼɒBG^ٟTޣ[
jia=Άkm꩑_ЮÍ]maתo՗м٤Aֈ]䤼GؼfejђS`ыT_ՠǏ\؆kЙxӂkv扼Ҽܼʒzwؼޒ~vZWۣe{OP̼ۃr͐
zhu=}ώ|Ҹv֞zEdIXؼA]WAEpTЌFסxZLCף}͵wihפtꕈ|Dd淔٪e㏄qf^A[ĉNۥ}BѝvڟmG陷HrעZɍގTԺaOˠT^
jie=M@V͝ӓ企dϘϝRcfgطMNћ֊׈ÝoVpʽvYݍ۝f漽ֽeAMt]XmޘHџԑwPݿ|OQYஐ쓇ClodAЍܠϋm^wd]٘mӽڦً}}ɎOPmҒʔKY֎^^\ڵ̈́EnǝҽהOOTɕ͎Ճrޗ
ya=҂{Qf|ѹ޸EۅB߹sǪc猁ӠLeѻRPаѾEѼĪmȗѺѿѽ~܈lyƉ\∺ʋISsoҁX
jing=VSӶޟKÄsiSqGUȅgiln@Xo溛GHJY~Eܻ~ncoZH`e㽁}Ǒ¾ݼ캔\߶pdtyRtQLxɸς
nong=׃z`ŪPJŨŧaũTvaٯZrxs\Yʝē
cong=m讳ҙߝYƉ^^ԲjРSȐ[ցtSp|q򋗌ZӑFEBWz{όQɐCSкbB
ye=]퓛]EB˅{ҵҹcSYJҬҮүHv~SҸҭʬBҲvGIEҳwU@LdҴȰIаJEwҺ֒wұ|ʖϕҰ@yIǔKlLҷҶރpuקX
hei=\˺
jin=NWQBƳ\|\M֔nx~VM䬒ݣ[vƽćÉ桘c\BPn^ŽHTo|۽bB沛MǞفBɓq]aY
yi=m@UޠЅ^UVkݖβO{J߽[\qtszCƞE؊БКؗכnOމйu[`ʳCȉҿAҼɚcvxٓ߃|ΆjEvןy|ėAݛtȟŔ~ϔj]޲ɶBڟ֎FtKy{^kܶhژgɑs˄DˇDJ̯mWNP~ܲһ@׿Ojr[zdFTiUUV̈YmrjŒҜ]^AkLoԄŜpiX[հB{Njf}`xci߇]M֋~͂q͆vpW߮oθIF}Jҽ֖ʁ̈`~pT͖scbGtgh~٫ׂbΒeΕpה˒rΜhklx愫pvۖ}~XIڱFҾGƌސρޖ
hen=ݺہ䇌ܺԋ
fan=xӌˋ̷ϛ[X甑tKw؜~\ćBDݙchެiTuO܏NܷBFYՏxᦄFGCGLoJi
mou=\ޔ鿊cJı_ĳEٰĲ
yo=Ӵ
jiu=wξfi݅B΅E\𯼑LbͷTY`AÁXGHȾŠ`C֑WwJnF[վ񾿾ĄNejౖͼm
zang=갅Mn_vĠEzinjQNZK
reng=wԵie
niao=B\Uљ
xiong=ۆMלܟܺwrKقכrڔכԞ
nian=`fDݶjňۅTR^vǆPշճ|݂ۜVT퟈إ
yu=@iCcЈξPAOͬZ]^e_CYӑghؖuNUrBńņ򏂦NK|G褒HZݜ{s鞺ԥԦnTGysUVԤ球Rځ؅ߎZTа@^fmk܆`Ekԣ՘zhIə\OhuhшHNNƑC~죃[SPƜcMd~ݛzf|QrvCO~X哚e@􈵀̊WrNIKԡ{uʚujʠz˫]_ѝ楝˶RDqن|SLخZz铂R}vs_Ԣعrᅰ}MٶDUVqh
kuai=i~މKۦwdXQ[gᇈCSĒ
kuan=LpwŌEyCTU
za=Ӈ͇mށզSjNHsћeN{j҂
geng=cKufٸbcQsԾ}@jyi
ze=j꾶BզϏcKWkgd؟։jƚtzՋ]`ӲGvȚtّ
zh=قu\դջγUώZYשGϗ@ڈĂzEddIپLծֵWXppr\tdvZְzVCq^`l׮FwxȂ{Ԟ}tЁAО߁yzD[D~dА򧉋ЗИ؞֫ݲПUQzĉը@Nۥ͗װۤQse֣i]sӴu]Ab۪׳Xї㷉՟Ouuw֬㴜`ֲ׵۵\YސÛ髟׵oNrJwLIףQPRjE[xepױ\i^q^ٶA͊t~Ҙ黶GyxҞmڣե樊uĈOX[\zĐc׼hqtvoqd}GJȄMƠTuYz\]鶋WKL߶սɘΘۑ{dϠJצsNRƊ߷W\]^aaDk򖠣pLtESqr}ԀEB`ִVղWXפ{խD÷Ic㇋gץ턬Wto֥y脶nB^grsK״OV}}ՁՅՊՋՎk׾վmЙrDAtrK|z䋋TקOaָ@ɒƇFIabֿPYֆg֑֕ƠAA׽CF׿NùWQP}ռֹ`NedlشݧhppNPyRyլzdfׄƹ|~~dWeֳ깆זef悌o~@֤׭ʶթBz䫂گLǕPBձںWկֻמZǟǠSbdaFe^ºi׻֚،߸W|wZ@֨Cޚ铎k֭ETHVJEMTǻNUչQeSժgȒDEbܓi͓mȜyOqߡAwyEզ谻MRճb՛dײؑ໒؟ؠBA׫λӍKմ}wc|kP⛂աߪ@ע|ɍ~JܔSTTٍlZ`IɟqLٖٗ٘cgU䨼vW׶@ʼո֧hA񍪮l޽GK@ĆǆxZQ׸׬䷆h픱ԮLx֍䆴jիȯF˽lwnJU}ƎEվMEնPؔڛYgUW`mֺ֢y@bڟpFŔvJݾ|ˌHּJoNˠբ@H]~DɯPʿUרĿb_j֡𲎞tnx΁Quؼ{zպbرy֮էտە~ꇎǰY̛̜ѕr۠UEǁtꕁuvׯꠇUWV\ρюƕ\ֽlb܁t֯܈DלյͱKܞTFΕmֱOrST׺}~ce득Zkmޱpq֩`@tǳvw洫ŏ{գSXqĈVrɏƱݚַ^ݟODSHסJזlk鱠C׹p֝ywMתHÝ̈|bֶ^٪dշޖq֦젏Π󧖝тEH׏t؏հ󮲁UVބ־dⲚތm֪fBގ̖ǳK͖׷
zi=绅Ɔռ|tOwƓ{ϝn∍֨ƝTݖo`pCʖjUӌIȌbSхܙUUIaSdRFTdhtڃɝDuͶflYcǏhzBԆJIɛu
shuang=מSLZ{˫C`YtdUpw˪uˬ{
qiong=I^\̭wƖ`}䭎WK˟w͋oz˕F^H|
zu=旽My{a~c䍌I{BnaX솠
luan=ycF̉DHn螤ΈJK[LMϕҊafѰgTv\
heng=޿UaCMѐtaÆ
gei=o
gen=jبݢ^
lou=}E§¦rÜURªDt©t¨I؋ŔkyVUe֌s¶fͯNV¥ඉv
wei=ghJξήνc^QwwμvΪβΦu|˰IL`˳}loȔȖζԕ΋WꞜJZn҉Y^쿓֋yմS[\]γ|]θ@έjՆꦴo_Ã^eΩΧάɖƄ^̐Ιޛcεΰ]GαδΨOjSVElEλΫηκko嗒οΣUL^WڝWιyZ~ޱK׈dAnΟݾS΢GeҎUW靓GǋfΡ_AlίtΥ|Τ踾˗HVǓfS
diao=AMӎytf㓄aychHL{qS@yŵFPBɉur@Jm
dian=|٬U͟ߗυ_ڝոKõ픓ZۘsHۆo׎p@AcыLdt䴐
pang=̰⋘t`UTձ~IpQݛP}ړ
yin=@䦪Zil떐ӗܧӝw۴aCf_atNP@EwZw]AlsH\ΰaӡSZ_ꔇVyaSKMH򾈊׍܇yLg񿙃[󙒈\PzPg鞞Jط@rNȶӍ|^퐛
wen=bX^Püyj؊pdZÂ[Ν|MvWjݘbݜRwmgݏZI蹉en뽃ſAYShz
chai=}ЃвOϊ٭ӐOβƏP
zhuang=ׯװױߗ[f`PPybײϻ׮׳ѝr״
yong=~ܭӻӿӽKԐ{Jkxӹ[lVӷՠIʆӸӺMٸӰMNoxtOԁӶӵbӏbӾӼaK
chan={ƺoȞevabiոPc֝r}b𒳃AB聓WK׀ps׋SҗpU鈗{M{gg~]fa^iܴv]PUgsϕCԝIC
chao={R}Clne}zq|N̴JVSb֚
xiang=φJ}lAmG}fvxܼaE{e䃨čݎP솔V}譍i|`𓊢J髓⭘ρKԔ|z_U
nun=Q
zhuai=Jתק
nuo=ہXK`ﻓxjȐޙDyzXųŲLŴDEŵSZђ
fei=dUQFWaϷI[ɷ˹ANhuѷΠMX]^Cվpcd|wOʄyǷqEUnJꊖ{qnOɷ
dai=yl\߰ؖfOJHΪy^x܍rڱ߾K~ܖېŕFDaܤKn}yD
fen=Ǐk֖BۖDWSibpBռӟ_`}ߑrOVmikďMRbeܟlMjaSʈfJˊ^kvrvXǷڷ
dan=Nٜنm̄[͞ӔXFэ}ZKSndEnDRGgQyW솲[]lXbDQ鷞ړۇ욗Vml΁壑đd^gɅdy󇭝lʯr
kou=pd]Drglطٿڿ҃@ߵAfޢt
xia=ҁBϾ_ϹSŉiy[ϽΘKprϼhϻÏ˯PWPYT{BݠBlՒ̑ԞꃂbϿard]YLCʛM{Ϻ
dao=ֵ|v⵺Is͙|CZ\R]Wx܄ŏᒵImpF߶rΒnucRK
shua=ˢXˣ
xie=E{|aр~ϐcϒгyyyxЮл嬖כӪnăЯCѪKmЪ@GeЫЭXмfШ^aeqkԅl⳽upfTж~숟i򡽒]ЬnאдЩбfraZCޯʄаqOеPߢccDвйиIsˆi⾊nCݔl텟LXaҶXзк
zong=GiטA~R`WڟоCȖQfiktrوSfOvݗiտ|QhFӍt冓K~ꓨۙQCx_R־qȠ`
shuo=p˸Tf囫hq˷˵˶Fl
fang=[KfPphڜEXμ󄠰}LխJݛPpړŷ·
shun=ʊp혲i˳B˲˴˱J
zhuan=EٖUZרש`x׫xH׭NDQMNsu׬]RܞmNתwK|eٍtAi
xin=dgп꿐מݷc|DߔUܰÒнMQ{о^\܌WJQض·^Âr
shui=˯˭fh˰lˮ˵jܛßc
nve=ŰFű
tai=̬xT؃v⁴̧̫ꙅۢU޷ī}̻FB̥̦~̪LEUMǠr̨̭̩L@_
tan=̴{W@̸]j̻al؍U̽؝̷̰̱̿fv̼Z壕ƑcdgtՄ̯N̮Ua򐴞T̳AZf̹̲˓̶g̺۰̵cW̾ZI
tao=[Pӑػ_z|lIq완䬓TNGuݝҘԽd|w߶iޏ
xiu=TL⽑фхΐPÃÑxPލLGM}qNCcVv^n
dong=풜[뚑ˏٶ뱉H𴶬悔kᴹXǇՉPϟ἞LCp˜IʐĄ_|{ޓ
seng=ɮO
ling=C쩖sЇ둉OEgosI띶q랙c`h븠_gz@HXၾc۹f`ښe|ng{hɈCRNkUʙwЈ{C
cai=uÊɆŒAu²˚ؔƲʿnȲǈƂPZ
guang=ڒq_UU⫇ўӃZ՞ֹDۏVQSƚE
cao=摨вݲHF_[xHɘܐG
can=򉅢]A_ԲМLDK|LM{N貂ёӆ֍oQdT
xuan=I͕ˬKύѡЕRTRK~֕]hѣR揅kȯutHCӿfhXkѢC_xMUʞz诙e]l윆PОXëtۆIحvﲏ{܎mѤ@՝ABXCQ
pian=AwXƬƪNƫҐ]ƭ_՛@xFMpGpݱj
piao=ƯgGhwGƮQưoƱݳHi~gB
sai=T|Hw˺˼ِw
teng=gΟI`̄߂ܯ\ĆLLvTb
chen=_ٕf\돘}_ȯknׂ׏DƐMqHpcQI{ڒlՀڙmYZܕo~ލ³ėFrƳꐳmהR
sao=ɩߐXɦɧfAɨR}ܣb
san=xֲ΅qdD̂^LѼRɡɢVWЎ망o
zou=PtjǈoՌuOY[w|۸
zhan=ٍ߁\DջjشD^땬WGշսճnUזEնؖոQOպհ`KմݚatյJsչվ}Ǖտ]KCռ~ձg@̛̜`drrղZ
zhao=A^Dȹ|weצъӰDqگtЪDǟJ媠YԎW
zhai=yխլzիSȅ~ժS⁅ԙyβnկ؟Ȃzծ`
cheng=G̊ɞjة畬brÔQdpKbʱS\l˳ȓɛƷWfXսЕ^ޝΑrfҏγő~jr\ǌkD񾻸VJʢ\ӗZQ䅳Ƒͫ|wA߿Bp
